--------------------------------------------------------------------------
[ANLAGENGRENZWERTE]	[0]
--------------------------------------------------------------------------
Regelung CR aktiv/inaktiv	Controller CR active/inactive	Controleur CR Activé/Désactivé				
Daten speichern	save Data	Sauvegarder les données				
Anlagengrenzwerte	Limiting Values	Valeurs Restrictives				
Abschaltgrenzen	Shut Off limit	Limite d'arrêt				
Warngrenzen	Warning limit	Seuil d'Alarme				
Sollwert	Setpoint	Point de consigne				
Parameter	Parameter	Paramètre				
Eingangsdruck FT-IR:	Inletpressure FTIR:	Pression d'entrée FT-IR:				
Durchfluss FT-IR:	Flow FTIR:	Flux FTIR:				
Druck Ausgang:	Pressure Outlet:	Pression de sortie:				
Heizleitungen intern:	Heated line internal:	Ligne chaufée interne:				
Heizung Filterblock:	Heated Filter:	Block Filtre Chauffé:				
Heizung Pumpe:	Heated Pump:	Pompe chauffée:				
Heizleitung Extern SP1:	Heated line external SP1:	Ligne chaufée externe SP1:				
Heizleitung Extern SP2:	Heated line external SP2:	Ligne chaufée externe SP2:				
Heizung Extern 1:	Heating external 1:	Chaufée externe 1:				
Heizung Extern 2:	Heating external 2:	Chaufée externe 2:				
FT-IR Heizung Messzelle:	Heated Gascell FTIR:	Cellule de gaz chauffée FTIR:				
Schaltschranktemperatur:	Cabinet Temperature:	Température d'Armoire:				
inaktiv	inactive	désactivé				
aktiv	active	activé		
Heizleitung zu FT-IR:	Heated line to FT-IR
Durchfluss CalGas:	Flow CalGas:		
--------------------------------------------------------------------------
[END]
--------------------------------------------------------------------------
---------------------------------------------------------------------------
[LOG KONFIG]	[1]
--------------------------------------------------------------------------
Log Konfig	Log Configuration	Configuration Journal				
Trigger Einstellungen	Trigger Configuration	Configuration Déclenchement				
Logdatei Messdaten	Log-file Measured data	fichier journal de données mesurées				
Bezeichnung:	Name:	Nom:				
Pfad für Spektren:	Spectrum Path:	Chemin du Spectre:				
FT-IR Spectrum	FTIR Spectrum	FT-IR Spectre				
(Der Pufferbereich wird vor dem Triggerereignis mitgeloggt)	(The Buffer size will be logged before the trigger event)	(La taille du tampon sera défini avant le déclenchement)				
kleiner	less then	Inférieur à				
größer	greater	Supérieur à				
-- Messwert	-- Reading	-- Lecture				
-- 24V Trigger-Eingang	-- 24V Trigger-Input	-- 24V Déclenchement				
-- Taste [F11]	-- Button [F11]	-- Touche [F11]				
-- AK-Befehl [STRG]	-- AK-Command [STRG]	-- AK Commande [STRG]				
-- START	--START	-- Départ				
Puffergröße:	Buffer size:	Taille du tampon:				
Triggerereignisse:	Trigger event:	Evénement déclencheur:				
Trigger verwenden?	Use Trigger?	Utilisation Déclencheur ?				
Pfad für Logdatei:	Log-file Path:	Chemin du fichier journal:				
Messreihenbezeichnung:	File name:	Nom de fichier:				
Logdatei erstellen?	Generate Log-file?	Générer un fichier journal?				
Spektrum Loggen?	Spectrum Logging?	Enregistrement du Spectre?				
Deaktiviert	disable	inactif				
Aktiviert	enable	actif				
max. Größe in Byte	max. Size in Byte					
--------------------------------------------------------------------------
[END]
--------------------------------------------------------------------------
---------------------------------------------------------------------------
[GASZUORDNUNG]	[2]
--------------------------------------------------------------------------
Grenzwerte speichern	Save Data	Sauvegarder les données				
Gaszuordnung AO	Gas assignment AO	Gaz affectation AO				
Einheit	Unit	Unité				
MIN - MAX Wert	MIN - MAX Value	Valeur Mini-Maxi				
Aktueller Wert	actual Value	Valeur actuelle				
Analogausgang in %	Analogoutput in %	Sortie Analogique en %				
Gasart	Gas type	Type de Gaz				
Analogausgang 1:	Analogoutput 1:	Sortie Analogique 1:				
Analogausgang 2:	Analogoutput 2:	Sortie Analogique 2:				
Analogausgang 3:	Analogoutput 3:	Sortie Analogique 3:				
Analogausgang 4:	Analogoutput 4:	Sortie Analogique 4:				
Analogausgang 5:	Analogoutput 5:	Sortie Analogique 5:				
Analogausgang 6:	Analogoutput 6:	Sortie Analogique 6:				
Analogausgang 7:	Analogoutput 7:	Sortie Analogique 7:				
Analogausgang 8:	Analogoutput 8:	Sortie Analogique 8:				
Analogausgang 9:	Analogoutput 9:	Sortie Analogique 9:				
Analogausgang 10:	Analogoutput 10:	Sortie Analogique 10:				
Analogausgang 11:	Analogoutput 11:	Sortie Analogique 11:				
Analogausgang 12:	Analogoutput 12:	Sortie Analogique 12:				
Analogausgang 13:	Analogoutput 13:	Sortie Analogique 13:				
Analogausgang 14:	Analogoutput 14:	Sortie Analogique 14:				
Analogausgang 15:	Analogoutput 15:	Sortie Analogique 15:				
Analogausgang 16:	Analogoutput 16:	Sortie Analogique 16:				
Analogausgang CR (0-10V)	Analogoutput CR (0-10V)	Sortie Analogique CR (0-10V)				
--------------------------------------------------------------------------
[END]
--------------------------------------------------------------------------
---------------------------------------------------------------------------
[ANLAGENÜBERSICHT]	[3]
--------------------------------------------------------------------------
Aktive Störungen	Errors	Erreurs				
CalGas zu PNS	CalGas to PNS	CalGaz vers PNS				
N2.....Stickstoff Gasförmig CR CA.....Druckluft CR CG.....Cal. Gas CR AA.....Umgebungs Luft CR PA.....Spülluft FT-IR CR  CR PR....Druckregler CR PS....Druckschalter CR FS....Flow Regler CR LS....Levelsensor CR FM...Flow Sensor	N2.....Nitrogen gaseous CR CA.....Compressed air CR CG.....Cal. Gas CR AA.....Ambient air CR PA.....Purge air FT-IR CR  CR PR....Pressure regulator CR PS....Pressure switch CR FS....Flow controller CR LS....Levelsensor CR FM...Flow Sensor	N2..… Azote gazeux CR CA Air comprimée CR CG….. Gaz Etalon CR AA…. Air Ambiant CR PA…. FT-IR Air de purge CR  CR PR…. Régulateur de pression CR PS… pressostat CR FS… controleur de flux CR LS…. Capteur Niveau CR FM… capteur de flux				
GN2 in	GN2 in	GN2 d'entrée				
Druckspeicher 5l	Reservoir 5l	Réservoir 5L				
Absaugung	Exhaust	Echappement				
Cal-Gas	Cal-Gas	Gaz Etalon				
Druckluft	CA in	Air comprimée d'entrée				
Anlagenübersicht	Process Chart	Schéma Processus				
Pumpe:	Pump:	Pompe:				
Ventilplatte:	Valveplate:					
Filter:	Filter:	Filtre:				
HL Ext.:	HL Ext.:	HL externe:				
HL zu Filter:	HL to Filter:	HL vers Filter:				
HL zu FT-IR:	HL to FT-IR:	HL vers FT-IR:				
Eingangsdruck FT-IR:	Pressure FT-IR:	Pression FTIR:				
Durchfluss FT-IR:	Flow FT-IR:	Flux FTIR:				
Temp. Messzelle:	Temp. Gascell:	Temp. Cellule de gaz:				
Druck Ausgang:	Pressure outlet:	Pression de sortie:				
Umgebungsdruck:	Ambient pressure:	La pression ambiante:				
Schaltschrank:	Cabinet temperature:	Temp. d'Armoire:				
Betriebsstunden Anlage:	Operating hours (unit):	Heures de service (appareil):				
Betriebsstunden Anlage / FTIR:	Operating hours (unit / FT-IR):	Heures de service (appareil / FT-IR):				
Betriebsstunden Pumpe:	Operating hours (measure):	Heures de service (mesure):				
Druck CalGas:	Pressure CalGas:	Pression CalGaz:				
HL Ext. SP1:	HL Ext. SP1:	HL ext. SP1:				
HL Ext. SP2:	HL Ext. SP2:	HL ext. SP2:				
Heizung Ext. 1:	Heating Ext. 1:	Chauffage ext.1:				
Heizung Ext. 2:	Heating Ext. 2:	Chauffage ext.2:				
Gaskühler:	Gascooler:					
Fluss PMD:	Flow PMA:					
Druck Kalter Block:	Pressure Cold Block:					
Taupunkt:	Dewpoint:					
PMA	PMD					
VFS - Inaktiv	VFS - Inactive					
VFS - Aktiv	VFS - Active					
VFS - FEHLER	VFS - ERROR					
--------------------------------------------------------------------------
[END]
--------------------------------------------------------------------------
---------------------------------------------------------------------------
[GRAFIK]	[4]
--------------------------------------------------------------------------
Graphen löschen	Clear graph	Effacer le graphique			g111111	
Grafik 6	Graphic 6	Graphique 6				
Grafik 5	Graphic 5	Graphique 5				
Grafik 4	Graphic 4	Graphique 4				
Grafik 3	Graphic 3	Graphique 3				
Grafik 2	Graphic 2	Graphique 2				
Grafik 1	Graphic 1	Graphique 1				
Konfig Diagramme	Config graph	Config Graph				
Grafik	Graphic	Graphique			g9999999999999	
Zoom deaktiviern	Deactivate Zoom
--------------------------------------------------------------------------
[END]
--------------------------------------------------------------------------
---------------------------------------------------------------------------
[CONFIG DIAGRAMME]	[5]
--------------------------------------------------------------------------
Graph 6:	Graphic 6:	Graphique 6:				
Graph 5:	Graphic 5:	Graphique 5:				
Graph 4:	Graphic 4:	Graphique 4:				
Graph 3:	Graphic 3:	Graphique 3:				
Graph 2:	Graphic 2:	Graphique 2:				
Graph 1:	Graphic 1:	Graphique 1:				
Y Anzeige MAX:	Y Scale MAX:	Maxi Echelle des Y:				
Y Anzeige MIN:	Y Scale MIN:	Mini Echelle des Y:				
Auto-Skalierung Y:	Auto-Scale Y:	Echelle des Y automatique:				
Auto-Skalierung X:	Auto-Scale X:	Echelle des X automatique:				
Fertig	Exit	Sortie				
Anzeigedauer X-Achse:	Manual Scale X:	Echelle des X manuelle:				
Konfiguration Grafik	Configuration Graph	Graph Configuration				
Werte	Average over	Moyenne de				
Mittelwertanzeige	Display average	Afficher la moyenne				
Konfiguration	Configuration	Configuration		
--------------------------------------------------------------------------
[END]
--------------------------------------------------------------------------
---------------------------------------------------------------------------
[KONFIGURATION FTIR]	[6]
--------------------------------------------------------------------------
Aktuelles Rezept:	Actual Recipe:	Recette actuelle:				
Betriebsstunden FT-IR:	Operating hours FT-IR:	Heures de service (FTIR):				
Gerätetype:	Device Type:	type de périphérique:				
Zykluszeit:	Scan Time:	Durée de balayage:				
Zykluszeit	Scan Time:	Durée de balayage:				
Diagnose FTIR	Diagnosis FTIR	FT-IR diagnostics				
Algebraic Konfig	Algebraic Config	Config Algébrique				
Hintergrund Spectrum	Background Spectrum	Spectre de bruit de fond				
Scan Zeit:	Scan Time:	Durée de balayage:				
Letzte Kalibrierung:	last Calibration:	Dernier Etalonnage:				
Anzahl:	Quantity:	Quantité:				
Startadresse:	Startadress:	Adresse démarrage:				
Algebraic (EVID Code):	Algebraic (EVID Code):	Algébrique (code EVID):				
Aktuelles Rezept:	Actual Recipe:	Recette actuelle::				
Konfiguration FT-IR	Configuration FT-IR	FT-IR Configuration				
Messwerte	Measured value	Valeur Mesurée				
Gasliste vergleichen	Compare Gaslist	Comparer Liste de gaz				
Aktuelle Gasliste	Actual Gaslist	Liste de gaz actuelle				
Allgemeine Parameter	General Parameters	Paramètres Généraux				
Diagnosewerte FT-IR	Diagnosis values FT-IR	Valeurs diagnostics FT-IR				
Instrument State:	Instrument State:	Statut Instrument:				
Number of Gases:	Number of Gases:	Nombre de Gaz:				
Number of Scan:	Number of Scan:	Nombre de scan:				
Linearizer Check:	Linearizer Check:	Vérification Linéariseur:				
Laser PP:	Laser PP:	Laser PP:				
Maximaler Wert	Maximum value	Valeur Maximum				
Minimaler Wert	Minimum value	Valeur Minimum				
Istwert	Actual value	Valeur actuelle				
Diagnose Zykluszeit	Diagnosis Cyclic time	Diag.durée du cycle				
Rezepte wechseln	Change recipe	xxx	
Komm. Leitsystem	Comm. Host	
--------------------------------------------------------------------------
[END]
--------------------------------------------------------------------------
---------------------------------------------------------------------------
[GASLISTE VERGLEICHEN]	[7]
--------------------------------------------------------------------------
ABBRECHEN	CANCEL	Annuler				
Gasliste identisch!	Gaslist identicall!	Liste de gaz identique!				
Gasliste unterschiedlich!	Gaslist NOT identicall!	Liste de gaz NON Identique!				
Neue Gasliste übernehmen	Assume new Gaslist	Accepter nouvelle liste de gaz				
Aktuell verwendete Gasliste	Actual used Gaslist	Liste de Gaz utilisée				
Vergleich Gaslisten	Compare Gaslist	Comparer Liste de gaz				
Neue Gasliste	New Gaslist	Nouvelle liste de gaz				
Gasliste vergleichen	Compare Gaslist 	Comparer Liste de gaz				
--------------------------------------------------------------------------
[END]
--------------------------------------------------------------------------
---------------------------------------------------------------------------
[ALGEBRAIC KONFIG]	[8]
--------------------------------------------------------------------------
Speichern	SAVE	Sauvegarder				
Name	Name	Nom				
Formel	Formula	Formule				
Abbrechen	CANCEL	Annuler				
OK?	OK?	OK?				
Gasliste	Gaslist	Liste de Gaz				
Algebraic Konfiguration	Algebraic Configuration	Configuration Algébrique				
valid	valid	valide				
invalid	invalid	invalide				
--------------------------------------------------------------------------
[END]
--------------------------------------------------------------------------
---------------------------------------------------------------------------
[FTIR DIAGNOSE]	[9]
--------------------------------------------------------------------------
Neue Referenz	New Referenc	Nouvelle référence				
Zeit	Time	Temps				
Amplitude	Amplitude	Amplitude				
Fertig	Exit	Sortie				
FTIR Diagnose	Diagnosis FTIR	Diagnostics FT-IR				
Background Igram	Background Igram	De Bruit de Fond Igram				
Background sBeam	Background sBeam	De Bruit de Fond sBeam				
sample Igram	sample Igram	le échantillon Igram				
sample Background	sample Background	le échantillon de Bruit de Fond				
sample Absorbance	sample Absorbance	le échantillon				
Aktuell	Actual	Actuel				
Referenz	Reference	la référence				
--------------------------------------------------------------------------
[END]
--------------------------------------------------------------------------
---------------------------------------------------------------------------
[ERWEITERTE KONFIG]	[10]
--------------------------------------------------------------------------
max. Ausgang:	Max. Output:	Max. Sortie:				
Istwert:	Actual value:	Valeur actuelle:				
Offset:	Offset:	Offset:				
Rohwert:	Raw value:	Valeur brut:				
Umgebungsdruck:	Ambient pressure:	La pression ambiante:				
Druck Ausgang:	Pressure Outlet:	Pression de sortie:				
Daten speichern	Save Data	Sauvegarder les données				
Dichtheitstest	Leak-check	Test de fuite				
Parameter Druckregler	Parameter Pressure controller	Paramètre controleur de pression				
Status Steuerung	Status PLC	Statut PLC				
Config AK	Config AK	Config AK				
Kühlung FT-IR aktiv:	Cooling FT-IR active:	Refroidissement FT-IR activé:				
Kühlung FT-IR inaktiv:	Cooling FT-IR inactive:	Refroidissement FT-IR désactivé:				
max. Anstieg:	Max. rise:	Augmentation maxi:				
Zeit:	Time:	Temps:				
Dichtheitstest:	Leak-check:	Test de fuite:				
Druck FT-IR IAG:	Pressure FTIR IAG:	Pression FTIR IAG:				
Kalibrierwert:	Calibration value:	Valeur d'étalonnage:				
Durchfluss FT-IR:	Flow FTIR:	Flux FTIR:				
Allgemeine Parameter	General Parameters	Paramètres Généraux				
Erweiterte Konfig	Advanced Configuration	Configuration avancée				
Max. Wert:	Max. value:	Valeur Maxi:				
Sollwert:	Set Point:	Point de consigne:				
Überwachung von Grundbedingnungen:	Monitoring:	Surveillance (Monitoring):				
Normaler Betrieb mit Überwachung	Normal operation with monitoring	Marche normale avec surveillance				
Überwachung deaktiviert (TESTBETRIEB!!!!)	Monitoring deactivated (Test operation!!!)	Surveillance désactivée (essai de fonctionnement!!!)				
Kühlung FT-IR:	Cooling FTIR:	Refroidissement FT-IR:				
Zustand Befüllsystem:	State of refillsystem:	Etat du Systeme de remplisage:				
Stunden	hours	Heures				
Befüllintervall:	Refill interval:	Intervalle de Rechargement:				
Fülldauer wenn Sensor erkannt:	Duration if sensor switched:	Durée si capteur changé:				
Zeitstempel - vorletzter Füllvorgang:	Timestamp - next to last filling operation:	Horadatage - dernière opération de remplissage:				
Zeitdauer letzter Füllvorgang:	Duration last filling operation:	Durée d'opération du dernier remplissage:				
Zeitstempel - letzter Füllvorgang:	Timestamp - last filling operation:	Horodatage - dernière opération de remplissage:				
Parameter Flüssig-Stickstoff-Nachfüllung	Adding of liquid Nitrogen Parameters	Ajouter les paramètres d'azote liquide				
Regelzonengrenze:	Regulate zone limit:	Limite de zone de régulation:				
Vorhaltezeit TD:	Derivative time TD:	Temps dérivé [TD]:				
Nachstellzeit TN:	Reset time TN:	Réinitialiser Temps TN:				
Verstärkung KR:	Intensification KR:	Intensification KR:				
PID -Parameter:	Regulate - Parameters:	Régulation - Paramètres:				
Heizung CR Filterblock	Heating CR Filterblock	Chauffage CR du Block Filtre				
Heizung CR Pumpe	Heating CR Pump	Chauffage CR Pompe				
Heizung CR Heizleitungen	Heated lines CR Internal	Ligne chaufée CR interne				
Heizleitung CR Extern	Heated lines CR External	Ligne chaufée CR externe				
Heizung CR Extern	Heating CR External	Chauffage CR externe				
Schnell ab:	Fast from:	Rapidement:				
Deaktiviert	Disable	inactif				
Aktiviert	Enable	actif				
Pumpe / Filter / FT-IR / PNS	Pump / Filter / FT-IR / PNS	Pompe / Filtre / FTIR / PNS				
Pumpe / Filter / FT-IR	Pump / Filter / FT-IR	Pompe / Filtre / FTIR				
Filter / FT-IR	Filter / FT-IR	 Filtre / FTIR				
FT-IR	FT-IR	FTIR				
--------------------------------------------------------------------------
[END]
--------------------------------------------------------------------------
---------------------------------------------------------------------------
[KONFIG AK]	[11]
--------------------------------------------------------------------------
Konfiguration AK-Schnittstelle	Configuration AK-Interface	AK-Interface Configuration				
Schnittstelle	Interface	Interface				
EKFG Befehl	EKFG Commando	Commande EKFG				
AK-Namen	AK-Name	AK-Nom				
AK-Status	AK-Status	AK-Statut				
AK TCP-Details	AK TCP-Details	AK TCP Informations				
Auswahl Gase (EKFG)	Gas Selection (EKFG)	Selection de gaz (EKFG)				
Seriell	Serial	Série				
AK Namen vergeben (für EKFG)	AK Name assign (for EKFG)	AK Nom assigné (pour EKFG)				
Serielle Schnittstelle:	Serial Interface:	Interface série:				
Baud rate:	Baud rate:	Vitesse de transmission:				
Data bits:	Data bits:	Bits de données:				
Parity bits:	Parity bits:	bit de parité:				
Stop bits:	Stop bits:	Bits Stop:				
Flow control:	Flow control:	Controle de flux:				
AK in Datei Loggen:	Storage AK to Log-file:	Stockage AK vers fichier journal:				
AK Befehlssatz:	AK Instruction set:	AK Jeu d'instruction:				
Löschen	Delete	Effacer				
Speichern	Save	Sauvegarder				
ABBRECHEN	Cancel	Annuler				
INAKTIV	INACTIVE	Inactif				
AKTIV	ACTIVE	Activé				
Gasliste	Gaslist	Liste de Gaz				
AK Namen	AK Name	AK Nom				
AK Namen verwenden	Use AK Name	User de AK Nom				
NEIN	NO	NON				
JA	YES	OUI				
Empfangspuffer	Receive buffer	Buffer reçu				
Antwort	Answer	Réponse				
Status AK-Kommunikation	Status AK-Communication	Communication Statut AK				
Konfig AK	Config AK	Config AK				
Messwerte nur in Messen übertragen:	Transfer data only in measure:					
EKFG vom Host	EKFG from Host		
Port Listener erstellt	Port Listener created
Port Listener initialisiert	Port Listener initialized
Port Listener beendet	Port Listener closed	
--------------------------------------------------------------------------
[END]
--------------------------------------------------------------------------
---------------------------------------------------------------------------
[STATUS STEUERUNG]	[12]
--------------------------------------------------------------------------
Status Steuerung	Status PLC	Statut PLC				
ABBRECHEN	Cancel	Annuler				
CPU Auslastung	CPU usage	Utilisation CPU				
CPU Speicher	CPU memory	Mémoire CPU				
PID Stellwerte	Controller Output	Sortie Controleur				
Heizung Filter:	Heating filter:	Chauffage du Filtre:				
Heizung Pumpe:	Heating Pump:	Chauffage Pompe:				
Heizung HL zu Filter:	Heating HL to filter:	Ligne chaufée vers Filtre:				
Heizung HL zu FT-IR:	Heating HL to FT-IR:	Ligne chaufée vers FTIR:				
Reserve:	Option:	las option				
Heizung HL SP1:	Heating HL SP1:	Ligne chaufée SP1:				
--------------------------------------------------------------------------
[END]
--------------------------------------------------------------------------
---------------------------------------------------------------------------
[PID PARAMETER DRUCK-REGLER]	[13]
--------------------------------------------------------------------------
PID Parameter Druck-Regler	Parameters Pressure Controller	Paramètre controleur de pression				
Regler Toleranz +:	Contr. tolerance +:	Tolérance +  de contrôle:				
Druck FT-IR	Pressure Inlet	Pression d'entrée				
Druck NDIR	Pressure NDIR	Pression NDIR				
Druck PMD	Pressure PMD	Pression PMD				
Druck Filter Block	Pressure Filter Block	Pression Filter Block				
Durchfluss FT-IR	Flow FT-IR	Flux FTIR				
Verstärkung KR:	Intensification KR:	Intensification KR:				
Nachstellzeit TN:	Reset time TN:	Réinitialiser Temps TN:				
Vorhaltezeit TD:	Derivative time TD:	Temps dérivé TD:				
Regler Toleranz INAKTIV	Controller tolerance inactive	Désactive Tolérance controleur				
Regler Toleranz AKTIV	Controller tolerance active	Active Tolérance controleur				
Regler Toleranz -:	Contr. tolerance - :	Tolérance -  de contrôle:				
Sollwert:	Setpoint:	Point de consigne:				
Istwert:	Actual:	Actuel:				
Regler OUT:	Controller OUT:	Sortie Controleur:				
Analog OUT:	Analog OUT:	Sortie Analogique:				
I-Action:	Intagral Action:	Action Intégrale:				
D-Action:	Derivative Action:	Action Dérivée				
Beenden	Cancel	Annuler				
Druck Ausgang	Pressure Outlet	Pression de sortie				
Pumpe (Durchfluss)	Flow (Pump)	Flux (Pompe)				
Sollwert	Setpoint	Point de consigne				
Istwert	Actual	Actuel				
Regler OUT	Controller OUT	Sortie Controleur				
Analog OUT	Analog OUT	Sortie Analogique				
I-Action	Intagral Action	Action Intégrale				
D-Action	Derivative Action	Action Dérivée				
PID Druckregelung	PID Pressure Controller	PID controleur de pression				
Amplitude	Amplitude	Amplitude				
Zeit	Time	Temps				
Gaskühler	Gas Cooler					
--------------------------------------------------------------------------
[END]
--------------------------------------------------------------------------
---------------------------------------------------------------------------
[DICHTHEITSTEST]	[14]
--------------------------------------------------------------------------
Dichtheitstest	Leak-check	Test de fuite				
Druck FT-IR:	Pressure FT-IR:	Pression FT-IR:				
max. Anstieg:	Max. increase:	Augmentation maxi:				
Druckanstieg:	Pressure increase:	Augmentation de pression:				
Verstrichene Zeit:	Elapsed time:	Temps écoulé:				
Zeitdauer:	Duration Time:	durée de temps:				
BEENDEN	Exit	Sortie				
Unterdruck wird Aufgebaut	Producing underpressure!	Mise en dépression				
Dichtheitstest läuft. Bitte Warten!	Leak-check is running. Please Wait!	Test de fuite en-cours. Merci de patienter				
Unterdruck von mindestent 70mbar nicht erreicht!	Underpressure of minimum 70mbar was not reached!	Dépression de 70mbar minimum n'a pas été atteinte				
Dichtheitstest beenden	Finish leak-check	Test de fuite Achèvement				
Druckanstieg zu HOCH!	Pressure increase too high!	Augmentation de pression trop elevée !				
Dichtheitstest OK!	Leak-check OK!	Test de fuite OK				
Ja	Yes					
Nein	No
Dichtheitstest speichern?	Save Leak-check?					
--------------------------------------------------------------------------
[END]
--------------------------------------------------------------------------
---------------------------------------------------------------------------
[T90 KONFIG]	[15]
--------------------------------------------------------------------------
Gaskomponente:	Gas component:	Composant de gaz:				
Mittelwert Anzahl:	Average over:	Moyenne de:				
Sollwert:	Setpoint:	Point de consigne:				
Modus:	Modus:	Mode:				
SPEICHERN	Save	Sauvegarder				
ABBRECHEN	Cancel	Annuler				
START	START	Départ				
T90 Konfig	T90 Configuration	T90 Configuration				
Abschaltzeit:	Timeout:	Temporisation:				
T90 Konfig 	T90 Config	T90 Config				
Abweichung:	Max. deviation:	Ecart maxi:				
Cal Gas zu PNS	Cal Gas to PNS	Gaz d'étalonnage sur PNS				
Cal Gas	Cal Gas	Gaz d'étalonnage				
Messen	Measure	Mesure				
--------------------------------------------------------------------------
[END]
--------------------------------------------------------------------------
---------------------------------------------------------------------------
[T90]	[16]
--------------------------------------------------------------------------
Gaskomponente	Gas component	Composant de gaz				
aktuelle Wert	Actual Value	Valeur actuelle				
T10 (Delay Time):	T10 (Delay Time):	T10 (Délai de temporisation):				
T90 (Response Time):	T90 (Response Time):	T90 (Temps de réponse):				
Abbrechen	Cancel	Annuler				
Speichern	Save	Sauvegarder				
Status	Status	Statut				
T90 - T10 (Rise Time):	T90 - T10 (Rise Time):	T90 - T10 (temps de montée):				
T90 Test	T90 Test	T90 Test				
Gas wird aufgeschalten	Gas switched on	Gaz ouvert				
Volle Konzentration erreicht!	Reached full Concentration!	Concentration Totale atteinte				
Prüfung wurde wegen einer Zeitüberschreitung abgebrochen!	T90 test was interrupt by a timeout!	T90 Test terminé				
Prüfung wurde gestartet	T90 test was started.	T90 Test lancé				
Prüfung wurde erfolgreich beendet!	Test successful completed	Test terminé avec succès!				
--------------------------------------------------------------------------
[END]
--------------------------------------------------------------------------
---------------------------------------------------------------------------
[HINTERGRUND]	[17]
--------------------------------------------------------------------------
FT-IR Hintergrund	FT-IR Background	Bruit de fond FTIR				
Hintergrund	Background	Bruit de fond				
STARTEN	Start	Départ				
ABBRECHEN	Cancel	Annuler				
Anforderung Hintergrund 	Request background	Requiert le Bruit de fond				
Vergleiche ob CO2 und H2O innerhalb Grenzen	Comparing if CO2 or H2O below limit 	Comparer si CO2 et H2O en-dessous des limites				
Hintergrund Abgebrochen! 	Background not started!	Bruit de fond non commencée				
Messgerät reagiert nicht! 	FT-IR do not respond!	FT-IR ne répond pas				
Hintergrund NICHT gestartet! 	Background NOT started!	Bruit de fond NON commencée				
H2O & CO2 zu hoch!	H2O or CO2 too high!	H2O & CO2 trop élevés				
Starte Hintergrund!	Start Background!	Démarrer Bruit de fond				
Hintergrund gestartet. Bitte Warten.	Background started. Please wait.	Bruit de fond en-cours, merci de patienter				
Hintergrund wurde wahrscheinlich nicht durchgefürht! 	Background was not completed successful!	Bruit de fond n'est pas arrivée à son terme				
Starte neuen Versuch	Start a new attempt!	Démarrer nouvelle tentative				
Hintergrund beendet.	Background finished.	Bruit de fond Terminée				
Kalibrierung FT-IR abgeschlossen	Finished taking background	Lecture Bruit de Fond Achèvement				
--------------------------------------------------------------------------
[END]
--------------------------------------------------------------------------
---------------------------------------------------------------------------
[SYSTEM EINSTELLUNGEN]	[18]
--------------------------------------------------------------------------
System Einstellungen	System Settings	Réglages du système				
Aktuelle Systemzeit Anlage:	Actual Time System:	Horloge System				
Aktuelle Systemzeit Steuerung:	Actual Time PLC:	Horloge PLC				
Systemzeit auf Steuerung aktualisieren	Update time on PLC	Mise à Jour Heure PLC				
Optionen	Options	Options				
Störmeldepuffer in Datei loggen:	Log Error-Message-Buffer to file:	Enregistrer Tampon Message Erreur vers fichier:				
Betriebszustände in Datei loggen:	Log System-state to file:	Enregistrer Etat du système vers fichier:				
Loggen während Cal-Gas:	Log while Cal-Gas:	Enregistrer pendant Cal-Gaz:				
Loggen während 0-Gas:	Log while 0-Gas:	Enregistrer pendant 0-Gaz:				
Loggen während CG zu PNS:	Log while CG to PNS:	Enregistrer pendant Cal-Gaz sur PNS:				
H2O, CO2 und O2 in ppm bei AK übergeben:	H2O, CO2 and O2 in ppm by AK assign:	H2O, CO2 & O2 en ppm assigné par AK:				
Automatische LN2 Befüllung vorhanden:	Automatic LN2 Refillsystem available:					
Klimaanlage vorhanden:	Airconditioner available:	climatisation disponible:				
Probenahmesystem verwenden:	PNS available:	PNS disponible:				
Messanlage steht im Container (AMC):	Measuring device in container (AMC):					
cRio Neustart	Restart PLC	Restart PLC				
Speichern	Save	Sauvegarder				
Fertig	Done	Fait				
Umrechner	Conversion	Calculateur				
Mit GN2 spülen:	Use GN2 for purge:	purgée à l'azote:
Dichtheitstest vor Kalibrieren:	Leak-check before Calibration:				
--------------------------------------------------------------------------
[END]
--------------------------------------------------------------------------
---------------------------------------------------------------------------
[COPYRIGHT]	[19]
--------------------------------------------------------------------------
Seriennummer:	Serialnumber:	Numéro de série:				
Software-Version:	Software-Version:	Version logiciel:				
--------------------------------------------------------------------------
[END]
--------------------------------------------------------------------------
---------------------------------------------------------------------------
[STATUSÜBERSICHT]	[20]
--------------------------------------------------------------------------
Statusübersicht	Status Overview	Synthèse du Statut				
Durchfluss FT-IR	Flow FT-IR	Flux FTIR				
Druck Ausgang	Pressure outlet	Pression de sortie				
Druck FT-IR IAG	Pressure FT-IR IAG	Pression FTIR IAG				
Druck CalGas	Pressure CalGas	Pression CalGaz 				
Heizleitung BMP zu Filter	Heated line Pump to Filter	Ligne chaufée Pompe vers Filtre				
Heizleitung Extern	Heated line External	Ligne chaufée externe				
FT-IR Austrittstemperatur	FT-IR Temperature	Température FTIR				
FT-IR Phasenwinkel	FT-IR Phase angel	angle de phase FTIR				
FT-IR Laserspannung	FT-IR Laser voltage	le voltage FTIR				
--------------------------------------------------------------------------
[END]
--------------------------------------------------------------------------
---------------------------------------------------------------------------
[PASSWORTVERWALTUNG]	[21]
--------------------------------------------------------------------------
Passwortverwaltung	Password administration	gestion du mot de passe				
Name	Name	Nom				
Passwort	Password	Mot de passe				
Level	Level	Niveau				
Speichern	Save	Sauvegarder				
Fertig	Cancel	Annuler				
--------------------------------------------------------------------------
[END]
--------------------------------------------------------------------------
---------------------------------------------------------------------------
[PASSWORT AENDERN]	[22]
--------------------------------------------------------------------------
Der aktuelle Passwort-Level erlaubt den Zugriff nicht. CR Geben Sie Ihr Passwort ein:	The current password level do not allowes the access. CR Enter your password:	Accès non autorisé à ce niveau de mot de passe. CR Entrer votre mot de passe:				
Passwort	Password	Mot de passe				
Aktueller Level	Current Level	Niveau actuel				
ABBRECHEN	CANCEL	Annuler				
Passwort falsch CR oder PW-Level zu niedrig!	Password wrong CR or PW-Level to low!	mot de passe niveau incorrect CR ou mot de passe à faible				
--------------------------------------------------------------------------
[END]
--------------------------------------------------------------------------
---------------------------------------------------------------------------
[FUNKTIONSTASTEN]	[23]
--------------------------------------------------------------------------
Standby	Standby	Veille				
Pause	Pause	Pause				
Eco	Eco	Eco				
Messen	Measure	Mesure				
Kalibrieren	Calibration	Etalonnage				
Spülen Filter	Flush Filter	Vidange filtre				
Spülen Leitung	Flush Line	Vidange de ligne				
Umgebungsluft	Ambient air	Air Ambiant				
0-Gas	0-Gas	0-Gaz				
Cal-Gas 1	Cal-Gas 1	Cal-Gaz 1				
CG zu PNS	CG to PNS	CG vers PNS				
-------------	-------------	-------------				
Init 1	Init 1	Init 1				
Init 2	Init 2	Init 2				
Init 3	Init 3	Init 3				
Init 4	Init 4	Init 4				
Messen vorbereiten	Messen vorbereiten	Messen vorbereiten				
Messen durchführen	Messen durchführen	Messen durchführen				
Exit	Exit	Exit				
Zeit abgelaufen	Time expired					
Taste betätigt	Key pressed					
AK-Befehl	AK-Command					
Auto Kalibrieren	Auto Calibration					
ANR Test	ANR Test					
CG-Test	CG-Test					
Dichtheitstest	Leak Check					
Kalibrieren	Calibration					
Bitparallel	Bitparallel					
Hang Up Test	Hang Up Test					
Linearisierung	Linearization					
Hintergrundscan LIN	Backgroundscan LIN					
Linearisierung FID	Linearization FID					
Linearisierung PMA	Linearization PMA					
Linearisierung FID GT	Linearization FID GT					
Linearisierung PMA GT	Linearization PMA GT					
LINVer	LINVer					
O2 Dichtheitstest	O2 Leak Check					
Fehler	Error					
T90 Test	T90 Test					
--------------------------------------------------------------------------
[END]
--------------------------------------------------------------------------
---------------------------------------------------------------------------
[PNS]	[24]
--------------------------------------------------------------------------
Reserve:	Option:	las option:				
Heizleitung 1:	Heated line 1:	Ligne  chauffée 1:				
Heizleitung 2:	Heated line 2:	Ligne  chauffée 2:				
Heizleitung 3:	Heated line 3:	Ligne  chauffée 3:				
Heizleitung 4:	Heated line 4:	Ligne  chauffée 4:				
Heizleitung 5:	Heated line 5:	Ligne  chauffée 5:				
Heizleitung 6:	Heated line 6:	Ligne  chauffée 6:				
Messgaspumpe:	Measuring gas pump:	Chauffage Pompe:				
Heiz-Kühlleitung 1:	Heated/cooled line 1:					
Heiz-Kühlleitung 2:	Heated/cooled line 2:					
Heiz-Kühlleitung 3:	Heated/cooled line 3:					
Heiz-Kühlleitung 4:	Heated/cooled line 4:					
Filter:	Filter:	Filtre:				
Ventilplatte:	Valveplate:					
Leitungsfilter 1:	Line filter 1:	filtre de ligne 1:				
Leitungsfilter 2:	Line filter 2:	filtre de ligne 2:				
Leitungsfilter 3:	Line filter 3:	filtre de ligne 3:				
Leitungsfilter 4:	Line filter 4:	filtre de ligne 4:				
HKH 1:	HKH 1:	HKH 1:				
Heizleitung 7:	Heated line 7:	Ligne  chauffée 7:				
Heizleitung 8:	Heated line 8:	Ligne  chauffée 8:				
Anlagengrenzwerte PNS	Limiting Values PNS	Valeurs Restrictives PNS				
Parameter	Parameter	Paramètre				
Sollwert	Setpoint	Point de consigne				
Warngrenzen	Warning limit	Seuil d'Alarme				
Abschaltgrenzen	Shutoff limit	Limite d'arrêt				
Regelung  CR aktiv/inaktiv	Controller  CR active/inactive	Controleur CR activé/désactivé				
aktiv	active	activé				
inaktiv	inactive	désactivé				
Gerätetyp:	Devicetype:	Type de périphérique:				
Allgemeine Werte	General Value	Valeur générale				
AWC Soll:	AWC target:	AWC cible:				
AWC IST:	AWC actual:	AWC actuel:				
Druckluft Störung:	Com.Air Error:	Erreur Com Air:				
Istwerte PNS	Actual Value PNS	Valeur actuelle PNS				
Status Kommunikation	Status Communication	Communication Statut				
Status:	Status:	Statut:				
Detail Status:	Detail Status:	Statut Informations:				
Fehlercluster	Errorcluster	cluster d'erreur				
Fehler	Error	Erreurs				
Status	Status	Statut				
Code	Code	code			
Seriennummer:	Serialnumber:						
--------------------------------------------------------------------------
[END]
--------------------------------------------------------------------------
---------------------------------------------------------------------------
[DIAG PNS]	[25]
--------------------------------------------------------------------------
Istwerte Probenahmesystem	Diagnosis PNS	diagnostics PNS				
BEENDEN	EXIT	Sortie				
Regler	Controller	Controleur				
Alarme	Alarms	Alarmes				
AWC Ist:	AWC Actual:	AWC actuel:				
Auswahl NW/M/BP:	Selection NW/M/BP:	Sélection NW/M/BP:				
AWC Netzwerk:	AWC Network:	AWC Réseau:				
AWC Manuell:	AWC Manuel:	AWC Manuel:				
AWC Bitparallel:	AWC Bitparallel:	AWC Bitparallel:				
Geräte Kennung:	Device recognition:	Reconnaissance de périphériques:				
Geräte Adresse:	Device Adress:	Adresse de périphériques:				
Druckluft Störung:	Com.Air Error:	Erreur sur arrivée d'air comprimée:				
AWC Soll	AWC Target	AWC cible				
--------------------------------------------------------------------------
[END]
--------------------------------------------------------------------------
---------------------------------------------------------------------------
[RUNTIME MENUE]	[26]
--------------------------------------------------------------------------
Beenden	Exit	Sortie				
Passwort Verwaltung	Password administration	gestion du mot de passe				
Konfig Störmeldungen	Error Message Config	Message d'erreur Config				
Störmeldepuffer	Error Message Buffer	Tampon Message d'Erreur				
Linearitätsnachweis	Lin Check	contrôle de linéarité				
Dichtheitstest	Leak Check	Test de fuite				
ARN Test	ARN Check	Essai de ARN				
Störmeldungen	Error Messages	Message d'erreur				
Diagnose Steuerung	Diagnosis PLC	Diagnostic du PLC				
Einstellungen	Settings	Réglages				
Statusübersicht	Status Overview	Synthèse du Statut				
PNS Grenzwerte	PNS limiting value	Valeurs Restrictives PNS				
FT-IR	FT-IR	FT-IR				
Linearisierung	Linearisation	Linéarisation				
Erw. Konfiguration	Advanced config	Configuration avancée				
Dichtheitstest §1065-345	Leakcheck §1065-345	Test de fuite §1065-345				
ANR Test §1065-305	ANR Test §1065-305	Essai de ANR §1065-305				
Linearitätsnachweis §1065-307	Linearity check §1065-307	contrôle de linéarité §1065-307				
System	System	Système				
Seiten	Pages	Pages				
Grafik	Graphic	Graphique				
Anlagenübersicht	Process chart	Schéma Processus				
Anlagengrenzwerte	Limiting values	Valeurs Restrictives				
Log Konfig	Log config	Configuration Journal				
Gaszuordnung AO	Gas assignment AO	Gaz affectation AO				
Erw. Konfig	Advanced config	Configuration avancée				
Störmeldeverwaltung	Error Message Administration	Message d'erreur d'administration				
HSV	HSV	HSV				
Konfiguration Kalibriergase	Config Calibration gas	xxx				
Querempfindlichkeitsnachweis §1065-366	Interference verification §1065-366					
PMD	PMA	PMA		
Spracheditor	Language editor			
Analysator	Analyzer
Querempfindlichkeitsnachweis §1065-366	Interference verification §1065-366
Querempfindlichkeitsnachweis §1065-375	Interference verification §1065-375
--------------------------------------------------------------------------
[END]
--------------------------------------------------------------------------
---------------------------------------------------------------------------
[FAS06]	[27]
--------------------------------------------------------------------------
Datum und Uhrzeit	Date and Time	Date et Heure				
Aktuelles Rezept	Actual Recipe	Recette actuelle				
LN2-Behälter Spülen	LN2-Dewar flush	LN2- Vidange Dewar				
Dewar Spülen	Dewar flush	vidange du Dewar				
LOGIN	LOGIN	Connexion				
LOGOUT	LOGOUT	Deconnexion				
Password-Level	Password-Level	Niveau de mot de passe				
Betriebsart	Operating mode	Mode opératoire				
Letzte Kalibrierung	Last calibration	Dernier Etalonnage				
Manuell	Manual	Manuel				
Remote	Remote	Distant				
Bitparallel	Bit-parallel	Bit en parallèle				
PMD	PMA	PMA				
--------------------------------------------------------------------------
[END]
--------------------------------------------------------------------------
---------------------------------------------------------------------------
[PERMANENT BEREICH]	[28]
--------------------------------------------------------------------------
Allgemein	General	Généraux				
Eingangsdruck FT-IR	Inlet Pressure FT-IR	Pression d'entrée FT-IR				
Durchfluss FT-IR	Flow FT-IR	Flux FTIR				
Heizleitung zu FT-IR	Heated line to FT-IR	Ligne chaufée vers FTIR				
Heizung Filter	Heating Filter	Block Filtre Chauffé				
Heizleitung zu Filter	Heated line to Filter	Ligne chaufée vers Filtre				
Heizung Pumpe	Heating Pump	Pompe chauffée				
Heizkreis FT-IR Messzelle	Heating FT-IR Gas Cell	FT-IR Cellule de Gaz				
Schaltschranktemperatur	Temperature cabinet	Température d'Armoire				
Messgasverbrauch Anlage	System Gas Consumption 					
--------------------------------------------------------------------------
[END]
--------------------------------------------------------------------------
---------------------------------------------------------------------------
[RUNTIME BEENDEN]	[29]
--------------------------------------------------------------------------
IAG Runtime herunterfahren!	Shut down IAG runtime!	Arrêter Execution IAG 				
Wie möchten Sie vorgehen?	How you want to proceed?	Comment voulez-vous procéder?				
IAG CR Visualisierung CR beenden!	Shut down!	Arrêter!				
Abbrechen!	Cancel!	Annuler!				
--------------------------------------------------------------------------
[END]
--------------------------------------------------------------------------
---------------------------------------------------------------------------
[SPEICHERN]	[30]
--------------------------------------------------------------------------
Bitte warten! CR  CR Daten werden gespeichert!	Please wait! CR  CR Saving data!	Patienter SVP! CR  CR Sauvegarde des données				
DATENTRANSFER  CR ABGEBROCHEN!	Data transfer  CR Cancel!	Données transférées CR Annuler!				
Daten gespeichert!	Data stored!	Données Enregistrées!				
Abbrechen	Cancel	Annuler				
Datentransfer	Data transfer	Données transférées				
--------------------------------------------------------------------------
[END]
--------------------------------------------------------------------------
---------------------------------------------------------------------------
[STOERMELDUNGEN]	[31]
--------------------------------------------------------------------------
Störmeldungen	Error Messages	Message d'erreur				
Quittieren	Quit	Quitter				
Nr.	Nr.	Nr.				
Zeit	Time	Temps				
Datum	Date	Date				
Info	Info	Info				
Text	Text	Texte				
--------------------------------------------------------------------------
[END]
--------------------------------------------------------------------------
---------------------------------------------------------------------------
[STOERMELDEPUFFER]	[32]
--------------------------------------------------------------------------
Störmeldepuffer	Error Message Buffer	Tampon Message d'Erreur				
Puffer LÖSCHEN	CLEAR Buffer	Effacer le tampon				
Nr.	Nr.	Nr.				
Zeit	Time	Temps				
Datum	Date	Date				
Zustand	State	Etat				
Text	Text	Texte				
--------------------------------------------------------------------------
[END]
--------------------------------------------------------------------------
---------------------------------------------------------------------------
[STOERMELDE-KONFIG]	[33]
--------------------------------------------------------------------------
Störmeldungs-Konfiguration	Configuration Error Messages	Messages d'erreur configuration				
Störungs- CR Nummer	Error CR Number	Numéro CR d'erreur				
Ansprech- CR verzögerung	Response CR delay	Délai  CR de réponse				
Quittieren	Quit?	Quitter?				
Abschalten	Shutoff?	Arrêt?				
Störung	Error	Fastidio				
Meldung	Message	Message				
Speichern	Save	Sauvegarder				
--------------------------------------------------------------------------
[END]
--------------------------------------------------------------------------
---------------------------------------------------------------------------
[STOERMELDUNGSDATEI]	[34]
--------------------------------------------------------------------------
Heizung Filter: Fühlerbruch Temperatursensor	Heating Filter: Sensor break	Chauffage Filtre: capteur défectueux				
Heizung Filter: Warngrenze wurde unterschritten	Heating Filter: Temperature below warning limit	Chauffage Filtre: Température en-dessous de la limite d'alerte				
Heizung Filter: Warngrenze wurde überschritten	Heating Filter: Temperature exceeded warning limit	Chauffage Filtre: Température au-dessus de la limite d'alerte				
Heizung Filter: Abschaltgrenze wurde unterschritten	Heating Filter: Temperature below shutoff limit	Chauffage Filtre: Température en-dessous de la limite d'arrêt				
Heizung Filter: Abschaltgrenze wurde überschritten	Heating Filter: Temperature exceeded shutoff limit	Chauffage Filtre: Température au-dessus de la limite d'arrêt				
Heizung Pumpe: Fühlerbruch Temperatursensor	Heating Pump: Sensor break	Chauffage Pompe: capteur défectueux				
Heizung Pumpe: Warngrenze wurde unterschritten	Heating Pump: Temperature below warning limit	Chauffage Pompe: Température en-dessous de la limite d'alerte				
Heizung Pumpe: Warngrenze wurde überschritten	Heating Pump: Temperature exceeded warning limit	Chauffage Pompe: Température au-dessus de la limite d'alerte				
Heizung Pumpe: Abschaltgrenze wurde unterschritten	Heating Pump: Temperature below shutoff limit	Chauffage Pompe: Température en-dessous de la limite d'arrêt				
Heizung Pumpe: Abschaltgrenze wurde überschritten	Heating Pump: Temperature exceeded shutoff limit	Chauffage Pompe: Température au-dessus de la limite d'arrêt				
Heizleitung zu Filter: Fühlerbruch Temperatursensor	Heated line to Filter: Sensor break	Ligne chauffée vers Filtre: capteur défectueux				
Heizleitung zu Filter: Warngrenze wurde unterschritten	Heated line to Filter: Temperature below warning limit	Ligne chauffée vers Filtre: Température en-dessous de la limite d'alerte				
Heizleitung zu Filter: Warngrenze wurde überschritten	Heated line to Filter: Temperature exceeded warning limit	Ligne chauffée vers Filtre: Température au-dessus de la limite d'alerte				
Heizleitung zu Filter: Abschaltgrenze wurde unterschritten	Heated line to Filter: Temperature below shutoff limit	Ligne chauffée vers Filtre: Température en-dessous de la limite d'arrêt				
Heizleitung zu Filter: Abschaltgrenze wurde überschritten	Heated line to Filter: Temperature exceeded shutoff limit	Ligne chauffée vers Filtre: Température au-dessus de la limite d'arrêt				
Heizleitung zu FT-IR: Fühlerbruch Temperatursensor	Heated line to FT-IR: Sensor break	Ligne chauffée vers FT-IR: capteur défectueux				
Heizleitung zu FT-IR: Warngrenze wurde unterschritten	Heated line to FT-IR: Temperature below warning limit	Ligne chauffée vers FT-IR: Température en-dessous de la limite d'alerte				
Heizleitung zu FT-IR: Warngrenze wurde überschritten	Heated line to FT-IR: Temperature exceeded warning limit	Ligne chauffée vers FT-IR: Température au-dessus de la limite d'alerte				
Heizleitung zu FT-IR: Abschaltgrenze wurde unterschritten	Heated line to FT-IR: Temperature below shutoff limit	Ligne chauffée vers FT-IR: Température en-dessous de la limite d'arrêt				
Heizleitung zu FT-IR: Abschaltgrenze wurde überschritten	Heated line to FT-IR: Temperature exceeded shutoff limit	Ligne chauffée vers FT-IR: Température au-dessus de la limite d'arrêt				
Heizleitung Extern SP1: Fühlerbruch Temperatursensor	Heated line external SP1: Sensor break	Ligne externe chauffée SP1: capteur défectueux				
Heizleitung Extern SP1: Warngrenze wurde unterschritten	Heated line external SP1: Temperature below warning limit	Ligne externe chauffée SP1: Température en-dessous de la limite d'alerte				
Heizleitung Extern SP1: Warngrenze wurde überschritten	Heated line external SP1: Temperature exceeded warning limit	Ligne externe chauffée SP1: Température au-dessus de la limite d'alerte				
Heizleitung Extern SP1: Abschaltgrenze wurde unterschritten	Heated line external SP1: Temperature below shutoff limit	Ligne externe chauffée SP1: Température en-dessous de la limite d'arrêt				
Heizleitung Extern SP1: Abschaltgrenze wurde überschritten	Heated line external SP1: Temperature exceeded shutoff limit	Ligne externe chauffée SP1: Température au-dessus de la limite d'arrêt				
Heizleitung Extern SP2: Fühlerbruch Temperatursensor	Heated line external SP2: Sensor break	Ligne externe chauffée SP2: capteur défectueux				
Heizleitung Extern SP2: Warngrenze wurde unterschritten	Heated line external SP2: Temperature below warning limit	Ligne externe chauffée SP2: Température en-dessus de la limite d'alerte				
Heizleitung Extern SP2: Warngrenze wurde überschritten	Heated line external SP2: Temperature exceeded warning limit	Ligne externe chauffée SP2: Température au-dessus de la limite d'alerte				
Heizleitung Extern SP2: Abschaltgrenze wurde unterschritten	Heated line external SP2: Temperature below shutoff limit	Ligne externe chauffée SP2: Température en-dessous de la limite d'arrêt				
Heizleitung Extern SP2: Abschaltgrenze wurde überschritten	Heated line external SP2: Temperature exceeded shutoff limit	Ligne externe chauffée SP2: Température au-dessus de la limite d'arrêt				
Heizung Extern 1: Fühlerbruch Temperatursensor	Heating external 1: Sensor break	Externe chauffée 1: capteur défectueux				
Heizung Extern 1: Warngrenze wurde unterschritten	Heating external 1: Temperature below warning limit	Externe chauffée 1: Température en-dessous de la limite d'alerte				
Heizung Extern 1: Warngrenze wurde überschritten	Heating external 1: Temperature exceeded warning limit	Externe chauffée 1: Température au-dessus de la limite d'alerte				
Heizung Extern 1: Abschaltgrenze wurde unterschritten	Heating external 1: Temperature below shutoff limit	Externe chauffée 1: Température en-dessous de la limite d'arrêt				
Heizung Extern 1: Abschaltgrenze wurde überschritten	Heating external 1: Temperature exceeded shutoff limit	Externe chauffée 1: Température au-dessus de la limite d'arrêt				
Heizung Extern 2: Fühlerbruch Temperatursensor	Heating external 2: Sensor break	Externe chauffée 2: capteur défectueux				
Heizung Extern 2: Warngrenze wurde unterschritten	Heating external 2: Temperature below warning limit	Externe chauffée 2: Température en-dessous de la limite d'alerte				
Heizung Extern 2: Warngrenze wurde überschritten	Heating external 2: Temperature exceeded warning limit	Externe chauffée 2: Température au-dessus de la limite d'alerte				
Heizung Extern 2: Abschaltgrenze wurde unterschritten	Heating external 2: Temperature below shutoff limit	Externe chauffée 2: Température en-dessous de la limite d'arrêt				
Heizung Extern 2: Abschaltgrenze wurde überschritten	Heating external 2: Temperature exceeded shutoff limit	Externe chauffée 2: Température au-dessus de la limite d'arrêt				
Heizung VFE 1: Fühlerbruch Temperatursensor	Heating VFE 1: Sensor break	Externe chauffée VFE 1: capteur défectueux				
Heizung VFE 1: Warngrenze wurde unterschritten	Heating VFE 1: Temperature below warning limit	Externe chauffée VFE 1: Température en-dessous de la limite d'alerte				
Heizung VFE 1: Warngrenze wurde überschritten	Heating VFE 1: Temperature exceeded warning limit	Externe chauffée VFE 1: Température au-dessus de la limite d'alerte				
Heizung VFE 1: Abschaltgrenze wurde unterschritten	Heating VFE 1: Temperature below shutoff limit	Externe chauffée VFE 1: Température en-dessous de la limite d'arrêt				
Heizung VFE 1: Abschaltgrenze wurde überschritten	Heating VFE 1: Temperature exceeded shutoff limit	Externe chauffée VFE 1: Température au-dessus de la limite d'arrêt				
Heizung VFE 2: Fühlerbruch Temperatursensor	Heating VFE 2: Sensor break	Externe chauffée VFE 2: capteur défectueux				
Heizung VFE 2: Warngrenze wurde unterschritten	Heating VFE 2: Temperature below warning limit	Externe chauffée VFE 2: Température en-dessous de la limite d'alerte				
Heizung VFE 2: Warngrenze wurde überschritten	Heating VFE 2: Temperature exceeded warning limit	Externe chauffée VFE 2: Température au-dessus de la limite d'alerte				
Heizung VFE 2: Abschaltgrenze wurde unterschritten	Heating VFE 2: Temperature below shutoff limit	Externe chauffée VFE 2: Température en-dessous de la limite d'arrêt				
Heizung VFE 2: Abschaltgrenze wurde überschritten	Heating VFE 2: Temperature exceeded shutoff limit	Externe chauffée VFE 2: Température au-dessus de la limite d'arrêt				
Heizung Flussregler: Fühlerbruch Temperatursensor	Heating Flow regulator: Sensor break	Externe chauffée Flow regulator: capteur défectueux				
Heizung Flussregler: Warngrenze wurde unterschritten	Heating Flow regulator: Temperature below warning limit	Externe chauffée Flow regulator: Température en-dessous de la limite d'alerte				
Heizung Flussregler: Warngrenze wurde überschritten	Heating Flow regulator: Temperature exceeded warning limit	Externe chauffée Flow regulator: Température au-dessus de la limite d'alerte				
Heizung Flussregler: Abschaltgrenze wurde unterschritten	Heating Flow regulator: Temperature below shutoff limit	Externe chauffée Flow regulator: Température en-dessous de la limite d'arrêt				
Heizung Flussregler: Abschaltgrenze wurde überschritten	Heating Flow regulator: Temperature exceeded shutoff limit	Externe chauffée Flow regulator: Température au-dessus de la limite d'arrêt				
Heizung wurde wegen Übertemperatur abgeschaltet	Heatings were switched off due to over temperature	Chauffages Arrêtés à cause de température excesssive				
Durchfluss FT-IR: Fühlerbruch Durchflusssensor	Flow FT-IR: Sensor break	Flux FTIR : Capteur défectueux				
Durchfluss FT-IR: Warngrenze wurde unterschritten	Flow FT-IR: Below warning limit	Flux FTIR : sous la limite d'alerte				
Durchfluss FT-IR: Warngrenze wurde überschritten	Flow FT-IR: Exceeded warning limit	Flux FTIR : au-dessus de la limite d'alerte				
Durchfluss FT-IR: Abschaltgrenze wurde unterschritten	Flow FT-IR: Below shutoff limit	Flux FTIR : sous la limite d'arrêt				
Durchfluss FT-IR: Abschaltgrenze wurde überschritten	Flow FT-IR: Exceeded shutoff limit	Flux FTIR : au-dessus de la limite d'arrêt				
Druck Ausgang: Fühlerbruch Durchflusssensor	Pressure outlet: Sensor break	Pression de sortie : capteur défectueux				
Druck Ausgang: Warngrenze wurde unterschritten	Pressure outlet: Below warning limit	Pression de sortie : en-dessous de la limite d'alerte				
Druck Ausgang: Warngrenze wurde überschritten	Pressure outlet: Exceeded warning limit	Pression de sortie : au-dessus de la limite d'alerte				
Druck Ausgang: Abschaltgrenze wurde unterschritten	Pressure outlet: Below shutoff limit	Pression de sortie : en-dessous de la limite d'arrêt				
Druck Ausgang: Abschaltgrenze wurde überschritten	Pressure outlet: Exceeded shutoff limit	Pression de sortie : au-dessus de la limite d'arrêt				
Druck Kalter Block: Fühlerbruch Sensor	Pressure Cold Block: Sensor break					
Druck Kalter Block: Warngrenze wurde unterschritten	Pressure Cold Block: Below warning limit					
Druck Kalter Block: Warngrenze wurde überschritten	Pressure Cold Block: Exceeded warning limit					
Druck Kalter Block: Abschaltgrenze wurde unterschritten	Pressure Cold Block: Below shutoff limit					
Druck Kalter Block: Abschaltgrenze wurde überschritten	Pressure Cold Block: Exceeded shutoff limit					
Störung Druckluftversorgung	Error Compressed air supply	Erreur arrivée d'air comprimée				
Fehler Spühlgas Versorgung	Error Purge air supply	Erreur arrivée d'air de purge				
Kondensatbehälter voll	Condensate reservoir full	Réservoir de condensat plein				
Kein Durchfluß von Cal-Gas	CalGas flow to low	Flux de CalGaz trop faible!				
Schaltschranktemperatur: Fühlerbruch Temperatursensor	Cabinet temperature: Sensor break	Température Armoire: capteur défectueux				
Warnung: Schaltschranktemperatur zu hoch	Cabinet temperature too high!!	Température Armoire trop elevée!				
Schaltschrank Temperatur hat Abschaltgrenze überschritten!!	Cabinet temperature: Exceeded warning limit	Température Armoire: dépassement seuil d'alerte				
Kühlung FT-IR: Fühlerbruch Temperatursensor	Cooling FT-IR: Sensor break	Refroidissement FT-IR : capteur défectueux 				
Ausblastemperatur FTIR über 50°C	FT-IR over temperature	FT-IR température au-dessus ( en surchauffe )				
Störung Klimaanlage	Error Air Conditioner	Erreur arrivée d'air conditionné				
Klimagerät nicht Eingeschaltet!	Air Conditioner switched off	Arrêt de l'air conditionné				
Dewar: Flüssiger Stickstoff geht zu Ende	Dewar: liquid nitrogen level is low	Dewar: niveau d'azote liquide faible				
Fehler: Flüssige Stickstoff Nachfüllung (System Überprüfen)	Error: liquid nitrogen refillsystem timed out (check the system)	Erreur: Arrêt du Système de remplissage d'Azote liquide (vérifier le système)				
Fehler LogFile! Speichern Fehlgeschlagen!	Error Log File! Saving failed!	Erreur fichier de consignation ! Sauvegarde échouée				
Störung Messgerät (Kommunikation gestört?)	FT-IR: Error Communication	FT-IR: Erreur de communication				
Messgerät nicht in RUN	FT-IR not in RUN mode	FT-IR n'est pas en mode MARCHE				
AK-Kommunikation zu FT-IR gestört!	Error AK-Communication to FT-IR!					
Hintergrundscan wurde nicht gestartet, da Feuchte und CO2 nicht innerhalb Grenzwerte	FT-IR: Error taking backgraund (Possibly CO2 or H2O too high)	FT-IR: Erreur lecture de Bruit de Fond (cause possible C02 ou H2O trop élevé)				
FT-IR: Temperatur von Heizleitung außerhalb Grenzwerte!	Heating FT-IR: Temperature heated line out of range	Chauffage FT-IR:  Temperature Ligne chauffée en-dehors des limites				
FT-IR: Temperatur von Messzelle außerhalb Grenzwerte!	Heating FT-IR: Temperature gascell out of range	Chauffage FT-IR:  Temperature Cellule de Gaz en-dehors des limites				
Heizung FTIR: Temperatur von Meßzelle hat Warngrenze unterschritten	Heating Gascell FT-IR: Temperature below warning limit	Chauffage Cellule de gaz FT-IR: Température en-dessous de la limite d'alerte				
Heizung FTIR: Temperatur von Meßzelle hat Warngrenze überschritten	Heating Gascell FT-IR: Temperature exceeded warning limit	Chauffage Cellule de gaz FT-IR: Température au-dessus de la limite d'alerte				
Heizung FTIR: Temperatur von Meßzelle hat Abschaltgrenze unterschritten	Heating Gascell FT-IR: Temperature below shutoff limit	Chauffage Cellule de gaz FT-IR: Température en-dessous de la limite d'arrêt				
Heizung FTIR: Temperatur von Meßzelle hat Abschaltgrenze überschritten	Heating Gascell FT-IR: Temperature exceeded shutoff limit	Chauffage Cellule de gaz FT-IR : Température au-dessus de la limite d'arrêt				
Eingangsdruck FT-IR: Warngrenze wurde unterschritten	Pressure FT-IR: Below warning limit	Pression FT-IR : en-dessous limite d'alerte				
Eingangsdruck FT-IR: Warngrenze wurde überschritten	Pressure FT-IR: Exceeded warning limit	Pression FT-IR : au-dessus limite d'alerte				
Eingangsdruck FT-IR: Abschaltgrenze wurde unterschritten	Pressure FT-IR: Below shutoff limit	Pression FT-IR : en-dessous limite d'arrêt				
Eingangsdruck FT-IR: Abschaltgrenze wurde überschritten	Pressure FT-IR: Exceeded shutoff limit	Pression FT-IR : au-dessus limite d'arrêt				
Grenzwertfehler sBeam@2500 - Mögl.Ursache: Gaszelle verschmutzt	FT-IR: sBeam@2500 - out of range	FT-IR : sBeam@2500 - hors gamme				
Grenzwertfehler laserPP - Mögl.Ursache: Laser am Ende	FT-IR: laserPP - out of range	FT-IR : Laser PP - hors gamme				
Grenzwertfehler Linearizer Check - Mögl.Ursache: Linearizer nicht richtig eingestellt	FT-IR: Linearizer Check - out of range	FT-IR : Test linéarisateur - hors gamme				
Fehler Dichtheitstest!	Error Leaktest!	Erreur: test de fuite!				
Keine Kommunikation mit Steuerung	Error Communication to PLC	Erreur: communication avec le PLC				
ACHTUNG: Grundbedingungen für Meßbetrieb werden nicht überwacht (TESTBETRIEB)	ATTENTION: Monitoring for Measure mode is deactivated! (TEST OPERATION)	ATTENTION: la surveillance pour le mode mesure est desactivé (essai de fonctionnement)				
Keine Kommunikation zu PNS	Error Communication to PNS	Erreur: communication avec le PNS				
PNS Störung Druckluftversorgung	PNS error compressed air supply	PNS erreur sur arrivée d'air comprimée				
 Fühlerbruch Temperatursensor	 Sensor break	 capteur défectueux				
 Warngrenze wurde unterschritten	 Temperature below warning limit	 température en-dessous de la limite d'alerte				
 Warngrenze wurde überschritten	 Temperature exceeded warning limit	 température au-dessus de la limite d'alerte				
 Abschaltgrenze wurde unterschritten	 Temperature below shutoff limit	 température en-dessous de la limite d'arrêt				
 Abschaltgrenze wurde überschritten	 Temperature exceeded shutoff limit	 température au-dessus de la limite d'arrêt				
Keine Kommunikation zu HSV	HSV: Error Communication	HSV: Erreur de communication				
Störung bei HSV steht an!	Error HSV!	Erreur arrivée d'HSV!				
Gaskühler: Warngrenze wurde überschritten	Gas cooler: Temperature exceeded warning limit					
Gaskühler: Abschaltgrenze wurde überschritten	Gas cooler: Temperature exceeded shutoff limit					
Heizleitung zu FID: Fühlerbruch Temperatursensor	Heated line to FID: Sensor break					
Heizleitung zu FID: Warngrenze wurde unterschritten	Heated line to FID: Temperature below warning limit					
Heizleitung zu FID: Warngrenze wurde überschritten	Heated line to FID: Temperature exceeded warning limit					
Heizleitung zu FID: Abschaltgrenze wurde unterschritten	Heated line to FID: Temperature below shutoff limit					
Heizleitung zu FID: Abschaltgrenze wurde überschritten	Heated line to FID: Temperature exceeded shutoff limit					
FID Kommunikation Fehler!	FID: Communication Error!					
FID Störung steht an!	FID: Failure!					
FID Funktionskontrolle - Messwerte ungültig!	FID: Funcional check - default measuring value					
FID Wartungsbedarf!	FID: Maintenance!					
FID Temperatur Detektor	FID: Temperature Detector					
FID Flammenfehler	FID: Flame-Error					
FID Störung Brennluft	FID: Error Combustion Air					
FID Störung Druck H2	FID: Error Pressure H2					
FID Störung Druck Eingang	FID: Error Pressure Inlet					
FID Störung Druck Ausgang	FID: Error Pressure Outlet					
FID Störung Durchfluss	FID: Flow Error					
Feuchtigkeit nach Gaskühler zu hoch!	Humidity after gas cooler is too high!					
Fühlerbruch Durchflusssensor PMD (-35B9)	Flowsensor break PMD (-35B9)					
Durchfluss PMD zu niedrig!	PMD flow too low!					
Fühlerbruch Drucksensor CalGas PMD (-35B8)	Pressuresensor break CalGas PMD (-35B8)					
Druck Cal Gas PMD zu niedrig!	Pressure CalGas to PMD too low!					
PMD Störung steht an!	PMD: Failure!					
PMD Funktionskontrolle - Messwerte ungültig!	PMD: Funcional check - default measuring value					
PMD Wartungsbedarf!	PMD: Maintenance!					
PMD Temperatur Detektor	PMD: Temperature Detector					
PMD Störung Luftdruck	PMD: Pressure Error					
PMD Kommunikation Fehler!	PMD: Communication Error!					
Fehler CalGas-Test! Vorzeitig beendet!	Error CalGas-Test! Aborted prematurely					
Fehler CalGas-Test! Span 1	Error CalGas-Test! Span 1					
Fehler CalGas-Test! Span 2	Error CalGas-Test! Span 2					
Fehler CalGas-Test! Span 3	Error CalGas-Test! Span 3					
Fehler CalGas-Test! Messgas - Eingang	Error CalGas-Test! Measure					
PMD: Kalibrierfehler	PMD: Error Calibration					
FID CH4: Kalibrierfehler	FID CH4: Error Calibration					
FID THC: Kalibrierfehler	FID THC: Error Calibration					
Auto Kalibrierung Timeout: Unbekanter Fehler	AUTO Calibration TIMEOUT! Unknown Error!					
PNS hat Werte nicht gespeichert	PNS did not store Values	PNS erreur sauvegarder				
Druck Cal-Gas niedrig!	Pressure Cal-Gas low!	
PNS Ausführung falsch. Bitte LP Ausführung anschließen.	Wrong PNS version. Please connect a PNS LP version.				
--------------------------------------------------------------------------
[END]
--------------------------------------------------------------------------
---------------------------------------------------------------------------
[ERWEITERTE GASLISTE]	[35]
--------------------------------------------------------------------------
Temp. Filter	Temp. Filter	Temp. Filtre				
Temp. Pumpe	Temp. Pump	Temp. Pompe				
Temp. HL zu FT-IR	Temp. HL to FT-IR	Temp. HL vers FT-IR				
Temp. Schaltschrank	Temp. Cabinet	Temp. Armoire				
Konstant 0	Constant 0	Constante 0				
Konstant 50	Constant 50	Constante 50				
Konstant 100	Constant 100	Constante 100				
AK DUMMY	AK DUMMY	AK DUMMY				
Temp. Messzelle	Temp. Gascell	Temp. Cellule de gaz				
Druck Messzelle	Pressure Gascell	Pression Cellule de gaz				
HSV Staudruck	HSV Dynamic Pressure					
HSV Luftdruck	HSV Ambient Air					
HSV Gasgeschwindigkeit	HSV Gasspeed					
--------------------------------------------------------------------------
[END]
--------------------------------------------------------------------------
---------------------------------------------------------------------------
[LINEARISIERUNG FTIR]	[36]
--------------------------------------------------------------------------
Linearisierung FT-IR	Linearisation FT-IR	Linéarisation FT-IR				
Komponente:	Component:	Composant:				
Prüfgas Konzentration:	Gas Concentration:	Gaz Concentration:				
max.Fehler:	max. Deviation:	Ecart maxi:				
Mittelwerte:	Average:	Moyenne:				
Messgerät:	Instrument:	Instrument:				
Kalibrator:	Calibrator:	Etalonneur:				
Bearbeiter:	Authorised User:	Utilisateur Autorisé:				
LIN Datei laden	LIN Data load					
Polynomkoeffizienten	Polynomial coefficients	Polynome Coefficients:				
File Name:	File Name:	Nom de fichier:				
Pfad:	Path:	Chemin:				
Polynom AKTIV:	Polynom ACTIVE:	Polynome Activé:				
Polynom koeffizienten:	Polynom coefficients:	Polynome Coefficients:				
Istwert:	Actual Value:	Valeur actuelle:				
Standardabweichung:	Standard Deviation:	Deviation standard:				
Sollwerte	Setpoint	Point de consigne				
Istwerte	Actual Values	Valeur actuelle				
Istwerte Abholen	Retrieve Actual Value	Retrouver Valeur Actuelle				
Istwerte Löschen	Delete Actual Value	Effacer la valeur actuel				
ALLES Löschen	Delete all	Tout effacer				
speichern	save	Sauvegarder				
Daten ermitteln	Determine data	Determiner les données				
LIN Anpassung	LIN Adjustment	LIN  Réglage				
Polynom-Ordnung	Polynom-Order	Polynome - commande				
Rohwerte	Raw Value	Valeur brut				
Linearisiert	Linearised Value	Valeur Linéarisée				
Sollwert	Setpoint	Point de consigne				
abs. Fehler (ppm)	abs. Deviation (ppm)	Deviation absolue (ppm)				
Gasteiler (ppm)	Gas divider (ppm)	Séparateur de gaz (ppm)				
Neues Polynom übernehmen	Set new Polynom 	Fixer le nouveau polynome				
Messgerät	Instrument	Instrument				
Kalibrator (Gasteiler)	Calibrator (Gas divider)	Etalonneur (diviseur de Gaz)				
Bearbeiter/in	Authorised User	Utilisateur Autorisé				
Komponente	Component	Composant				
Zeitstempel	Timestamp	Horodatage				
F_max gefordert (%)	Required max. Deviation (%)	Deviation Maxi requise (%) 				
F_max in %	Deviation max in %	Déviation Maxi en % 				
F_max in ppm	Deviation max in ppm	Déviation Maxi en ppm 				
Prüfgas Konzentration	Gas Concentration	Gaz Concentration				
Polynomkoeff.	Polynomcoeff.	Polynomecoeff.				
Vorschlag Ordnung	Proposition Order	Proposition de Commande				
Polynom OK	Polynom OK	Polynome OK				
abs. Fehler	abs. Deviation	Deviation abs.				
rel. Fehler	rel. Deviation	Deviation Rel.				
% v. Sollw.	% f. Setpoint	% de la valeur fixée				
Deviation	Deviation	Deviation				
Temp.Messzelle	Temp. Gascell	Temp. Gaz Cell.				
Druck Messzelle	Pressure Gascell	Press. Gaz Cell.				
Datum	Date	Date				
Uhrzeit	Time	Temps				
geford. max. Fehler (% v. Sollw.)	Required max. Deviation (%)	Deviation Maxi requise (%)				
erreichter max. Fehler (%)	Deviation max in %	Déviation Maxi en %				
erreichter max. Fehler (ppm)	Deviation max in ppm	Déviation Maxi en ppm				
Polynom-Ordnung	Polynom-Order	Polynome-commande 				
Ordnung festgelegt	Order selected					
geforderte Genauigkeit	max. Deviation	Ecart maxi				
erreicht	passed	passé				
NICHT erreicht	failed	Echoué				
Lin-Polynom:	Lin-Polynom:					
konstanter Koeff	constant Coeff					
linearer Koeff	linear Coeff					
quadrat. Koeff	2. Order					
3. Ordg	3. Order					
4. Ordg	4. Order					
Messw. roh	Raw Value	Valeur brut				
Linearisiert	linearized					
manuell	manual					
automatisch	automatic					
Fehler beim schreiben der Daten	Error write Data!					
Daten gespeichert!	Data stored!					
Neues Polynom gespeichert!	New Polynom stored!					
LIN Datei laden	LIN Data load					
Beenden	Cancel	Annuler				
--------------------------------------------------------------------------
[END]
--------------------------------------------------------------------------
---------------------------------------------------------------------------
[ARN TEST]	[37]
--------------------------------------------------------------------------
Anderer Test läuft gerade. CR Bitte etwas Geduld.	Another Test is running. CR Please wait a moment.
Bearbeiter:	Operator:
Messgerät:	Analyzer:
Seriennummer:	Serial number:
Komponente:	Component:
Gasflaschen Nr.:	Gas Bottle Nr.:
Konzentration:	Setpoint:
Genauigkeit:	Accuracy:
CG Aufschaltzeit:	CG Purge Time:
Abweichung:	Deviation:
Abschaltzeit:	Timeout:
Pfad:	Path:
Textname:	Filename:
Protokoll Einstellung	Protocol Settings
Allgemeine Einstellungen	General Settings
Einstellung	Settings
Ergebnis	Result
Speichern	Save
Abbrechen	Cancel
Istwert:	Actual Value:
PDF erstellen	Print to PDF
Grenzen	Limits
ANR Test	ANR Test					
Einstellungen	Settings		
Grafik	Graphic					
Bearbeiter:	Operator:					
Komponente:	Component:					
Konzentration:	Concentration:					
Modus:	Modus:
0-Gas	0-Gas					
CalGas	CalGas					
CalGas zu PNS	CalGas to PNS					
Nr.:	Nr.:					
SOLL Wert	Set Value					
IST Wert	Actual Value					
Deviation	Deviation					
abs.Fehler	abs.Error
rel.Fehler	rel.Error					
Grenzwerte:	Limits:					
Ergebnis:	Results:					
Genauigkeit:	Accuracy:					
Wiederholgenauigkeit:	Repeatability:					
Rauschen:	Noise:					
Start	Start					
Abbrechen	Cancel					
Protokolleinstellungen	Protocol settings					
Speichern	Save					
Start ARN Test Start ARN Test 						
CalGas wird aufgeschalten. 	Purge the device with CalGas 					
Aufschaltzeit wird abgewartet	Purge time is running...					
Datenaufzeichnung Nr.	Data recording Nr.					
 gestartet	 was started					
Daten gespeichert	Data are stored	
N2 Daten gespeichert	0-Gas data are stored				
Daten ausgewertet	Data are evaluated!					
ARN-Test abgebrochen!	ARN-Test canceled!					
nicht bestanden!	failed!					
bestanden!	passed!					
ARN-Test 	ARN-Test 					
Datenaufzeichnung gestartet.	Data recording started.					
O2 Leaktest beendet.	O2 Leaktest passed.
0-Gas wird aufgeschalten	Purge the device with 0-Gas	
CG zu PNS	Cal Gas to PNS	Gaz d'étalonnage sur PNS		
CG zu Entnahmestelle	Cal Gas to Samplepoint
N2 Aufschaltzeit:	N2 Purge Time:			
--------------------------------------------------------------------------
[END]
--------------------------------------------------------------------------
---------------------------------------------------------------------------
[ARN PROTOKOLL]	[38]
--------------------------------------------------------------------------
Nr.:	Nr.:					
Sollwert	Set Value					
IST Wert 	Actual Value					
Standartabweichung	Standard Deviation					
abs. Fehler	abs. Error					
ARN - Test § 1065.305 Auswertung laut Table 1 of §1065.205	ARN - Test § 1065.305 Evaluation according to Table 1 of §1065.205					
Genauigkeit: 	Accuracy: 					
 bestanden!	 passed!					
 nicht bestanden!	 failed!					
Wiederholgenauigkeit: 	Repeatability: 					
Rauschen: 	Noise: 					
ARN-Test §1065.305	ARN-Test §1065.305					
Datum und Uhrzeit:	Date and Time:					
Bearbeiter:	Operator:					
Messgerät:	Analyzer:					
Komponente:	Component:					
Fehler beim schreiben der Daten	Error write Data!					
Daten gespeichert!	Data stored!
Grenzwerte:	Limits:					
Ergebnis:	Results:
Grenzen	Limits					
Ergebnis	Results					
Genauigkeit:	Accuracy:					
Wiederholgenauigkeit:	Repeatability:					
Rauschen:	Noise:
Gasflaschen Nr.:	Gas Bottle Nr.:	
Sollwert:	Setpoint:
Seriennummer:	Serial number:	
Methode (Rezept):	Method (Recipe):
Datum & Zeit:	Date & Time:
Anlage:	Measuring Device:				
--------------------------------------------------------------------------
[END]
--------------------------------------------------------------------------
---------------------------------------------------------------------------
[FEHLER STEUERUNG]	[39]
--------------------------------------------------------------------------
Fehler Steuerung	Error PLC					
Beenden	Cancel					
Quittieren	Quit					
 CR Fehlercode	 CR Errorcode					
 CR Schweregrad	 CR Severity Code					
Zeitstempel  CR (erster Eintritt)	Timestamp  CR (first Inlet)					
 CR Anzahl	 CR Quantity					
Fehler Puffer	Error Buffer					
Aktuelle Fehler	Actual Error					
cRIO Fehlerliste	cRIO Errors					
--------------------------------------------------------------------------
[END]
--------------------------------------------------------------------------
---------------------------------------------------------------------------
[POLYNOMKOEFFIZIENTEN]	[40]
--------------------------------------------------------------------------
SPEICHERN	Save					
Gasliste	Gaslist					
Namen	Name					
Polynomkoeffizienten	Polynomial coefficients					
AKTIV	ACTIVE					
ABBRECHEN	Cancel					
--------------------------------------------------------------------------
[END]
--------------------------------------------------------------------------
---------------------------------------------------------------------------
[KONFIG LINEARITY VERIFICATION]	[41]
--------------------------------------------------------------------------
Konfiguration Linearity Verification	Configuration Linearity Verification					
Gasteiler Einstellungen	Setting Gasdivider					
Gasteiler:	Gasdivider:					
Stufen:	Points:					
Gasteiler Type:	Gasdivider Type:					
Status:	Status:					
Anforderung	Connect					
Freigabe	Disconnect					
Druck CG zu Gasteiler:	Pressure CG to Gasdivider:					
Störung Kommunikation	Error Communication					
Pressure carrier gas	Pressure carrier gas					
Pressure diluted gas	Pressure diluted gas					
Outlet Pressure	Outlet Pressure					
SNOX before SAIRS	NOX before SAIR					
IP-Adresse:	IP Adress:					
Port:	Port:					
Einstellungen Lin-Verification	Settings Lin-Verification					
Stufen Tabelle	List of Points					
Stufen Abfragen	Scan Points					
SPEICHERN	Save					
Komponente:	Component:					
Konzentration:	Concentration:					
Summenformel:	Formula:					
Prüfgas in:	Calibrationgas in:					
Anzahl Stufen:	Number of Points:					
Zeitdauer pro Stufe:	Duration per Point:					
Max Fehler (Sollwert):	Max Error (target value):					
Bearbeiter:	Operator:					
Kalibrator:	Calibrator:					
Inlet Gas:	Inlet Gas:					
LinVerification	LinVerification					
LNI Digital	LNI Digital					
LNI Analoge	LNI Analoge					
AVL Gasteiler	AVL Gasdivider					
Gasteiler CR Keine Anforderung! CR Mit manuellen LIN-Check weiter?	Gasdivider CR Not connected! CR Continue with manual LIN-Check?					
Gasteiler CR Keine Anforderung!	Gasdivider CR Not connected!					
JA	YES					
NEIN	NO					
Bitte	Please					
Warten	Wait					
OK	OK					
Gasteiler CR Keine Anforderung! CR Mit manuellen FTIR-LIN weiter?	Gasdivider CR Not connected! CR Continue with manual FTIR-LIN?					
Daten wurden gespeichert!	Data saved!	xxx				
PMD Kalibrieren. CR AutoKal PMD gestartet.	PMD Calibration. CR AutoCal PMD started.					
Kalibrierung:	Calibration:					
Temp. Messzelle	Temp. Measuring Cell					
FID Kalibrieren. CR AutoKal FID gestartet.	FID Calibration. CR AutoCal FID started.					
E-Gas am Gasteiler aufgeschalten.	E-Gas switched on at gasdivier.					
Keine Anforderung Gasteiler! CR Gas manuell aufschalten!	No Connection to Gasdivider! CR Switch on Gas manually!					
Keine Anforderung Gasteiler! CR 0-Gas manuell aufschalten!	No Connection to Gasdivider! CR Switch on 0-Gas manually!					
0-Gas am Gasteiler aufgeschalten	0-Gas switched on at gasdivier					
Gasteiler CR Keine Anforderung!	No Connection CR to Gasdivider!					
Daten gespeichert!	Saved data!					
Fehler beim schreiben der Daten	Error writing data					
Keine Anforderung Gasteiler!	No Connection to Gasdivider!					
Neues Polynom gespeichert!	New Polynom saved!					
EPA Test nicht gültig! CR Mindestens 10 aktive Punkte nötig. CR PDF wurde nicht erzeugt	EPA Test not valid! CR at least 10 active points necessary. CR PDF not created					
--------------------------------------------------------------------------
[END]
--------------------------------------------------------------------------
---------------------------------------------------------------------------
[AUTO LIN VERIFICATION]	[42]
--------------------------------------------------------------------------
Daten ermitteln	Determine data					
Auswertung	Evaluation					
Linearität nach EPA §1065.307 überprüfen	Linearity detection according to §1065.307					
Istwert:	Actual Value:					
Rohwert:	Raw Value:					
Deviation:	Deviation:					
Inlet Gas:	Inlet Gas:					
Status	Status					
STARTEN	START					
Schließen	Exit					
Linearitätsnachweis §1065.307	Linearity detection §1065.307					
Messwerte Analysator in ppm oder %	Analizer readings in ppm or %					
Vorgabewerte Kalibriergas  in ppm oder %	Setpoint Gasdivider in ppm or %					
File Name:	File Name:					
Pfad:	Path:					
speichern	save					
Beschreibung der Grenzen:	Description of the limits					
Steigung (a1) Wert zwischen 0,99-1,01	Slope (a1) value between 0,99-1,01					
Steigung (a1)	Slope (a1)					
Achsenabschnitt (a0)	Intercept (a0)					
Labor: Wert <=  0,5% von der Kalibriergaskonzentration	laboratory: Value <= 0,5% of the gas concentration					
Feld: Wert <=  1% von der Kalibriergaskonzentration	field: Value <= 1% of the gas concentration					
Bestimmtheitsmaß (R²) Wert >= 0,998	Coefficient of determination (R²) Value >= 0,998					
Standart Fehler (SEE) Wert <= 1% von der Kalibriergaskonzentration	standard error of estimate (SEE) Value <= 1% of the gas concentration					
Fehler Gasteiler steht an!	Error Gasdivider					
bestanden	passed					
Fehler beim schreiben der Daten	Error while saving data					
Daten gespeichert!	Saved data!					
Ohne Speichern Beenden?	Exit without saving?					
Linearitätsnachweis §1065.307  routine gestartet	Linearity detection §1065.307 routine started					
Sollwerte	Setpoint					
Istwerte	actual value					
abs. Fehler	abs. Error					
rel. Fehler	rel. Error					
% v. Sollw.	% f. Setp.					
Deviation	Deviation					
Messergebnisse sind innerhalb der geforderten max. Abweichung von 2%	Measurement results are inside the required max. Error of 2%					
Messergebnisse sind außerhalb der geforderten max. Abweichung von 2%	Measurement results are outside the required max. Error of 2%					
Der Linearitätsnachweis nach §1065.307 wurde bestanden.	Linearity detection according to §1065.307 was passed					
Der Linearitätsnachweis nach §1065.307 wurde nicht bestanden.	Linearity detection according to §1065.307 was failed					
Max. Abweichung in % <= 2% von der Kalibriergaskonzentration	Max. Error in % <= 2% of the gas concentration					
Bestimmtheitsmaß (R²)	Coefficient of determination (R²)					
Standart Fehler (SEE)	standard error of estimate (SEE)					
Max. Abweichung in %	Max.Error in %					
Auswertung nach EPA § 1065.307	Evaluation according to §1065.307					
Istwert   	value     					
Grenzen   	limits    					
Prüfung	Test					
nicht bestanden	failed					
Messgerät	Measuring device					
Kalibrator (Gasteiler)	Calibrator (Gasdivider)					
Bearbeiter/in	Operator					
Komponente	Component					
Datum	Date					
Uhrzeit	Time					
Linearity Verification nach EPA §1065.307	Linearity Verification according to §1065.307					
LIN routine gestartet	LIN routine started					
JA	YES	xxx				
NEIN	NO	xxx				
Datenaufzeichnung wurde gestartet!	Data recording started!					
Punkt	Point					
wurde aufgeschaltet	switched on					
Daten werden abgeholt	Retrieve Actual Value					
Daten Abholung wird beendet	Retrieve value finished					
Gasteiler und Anlage werden gespült	flushing Gasdivider and Device					
Datenaufzeichnung wurde beendet!	Data recording stopped!					
Datenaufzeichnung wurde aufgrund eines Fehlers angehalten.	Data recording stopped due to Error.					
Datenaufzeichnung wird neu gestartet.	Data recording started again.					
--------------------------------------------------------------------------
[END]
--------------------------------------------------------------------------
---------------------------------------------------------------------------
[GRAPHIK KURVEN]	[43]
--------------------------------------------------------------------------
Komponenten	Components
Beenden	Close
Grafik	Graphic
--------------------------------------------------------------------------
[END]
--------------------------------------------------------------------------
---------------------------------------------------------------------------
[EPA DICHTHEITSTEST]	[44]
--------------------------------------------------------------------------
Anderer Test läuft gerade. CR Bitte etwas Geduld.	Another Test is running. CR Please wait a moment.
Dichtheitstest nach §1065.345	Leak-Check  EPA CRF40 §1065.345 				
Status	Status					
Heizleitung CR zum CR VFS	Heated line CR to CR VFS					
Heizleitung CR zur CR Entnahmestelle	Heated Line CR to CR Sampling point					
Gesamtvolumen Versa	Total volume Versa					
Innendurchmesser  CR HL zu VFS	Inner diameter   CR HL to VFS					
Länge HL zu VFS	Length HL to VFS					
Gesamtvolumen VFS	Total volume VFS					
Innendurchmesser  CR HL zu SP	Inner diameter  CR HL to SP					
Länge HL zu SP	Length HL to SP					
Druck FT-IR:	Pressure FT-IR:					
Druckanstieg:	Pressure increase:					
Start	Start					
Abbrechen	Cancel					
Grenzwert	Limit Value					
Ergebnis	Result					
Volumen-Einstellungen	Volume Parameter					
Protokolleinstellungen	Protocol settings					
Pfad:	Path:					
Textname:	Textname:					
Speichern	Save					
Unterdruck wird Aufgebaut	Producing underpressure!					
Dichtheitstest läuft. Bitte Warten!	Leak-check is running. Please Wait!					
Unterdruck von mindestent 70mbar nicht erreicht!	Underpressure of minimum 70mbar was not reached!					
Dichtheitstest beenden	Finish leak-check					
Druckanstieg zu HOCH!	Pressure increase too high!					
Dichtheitstest OK!	Leak-check OK!					
Dichtheitstest abgebrochen!	Leak Check canceled!					
nicht Bestanden	failed					
Bestanden	passed					
Dichtheitsnachweis laut EPA §1065.345	Leak-Check according EPA CRF40 § 1065.345 					
Datum Uhrzeit:	Date/Time:					
Auswertung:	Evaluation:					
Gesamtes Volumen:	Total Volume:					
Zeitstempel am Beginn der Prüfung (t1):	Timestamp at the beginn of the test (t1):					
Zeitstempel am Ende der Prüfung (t2):	Timestamp at the end of the test (t2):					
Druck (p1):	Pressure (p1):					
Druck (p2):	Pressure (p2):					
Temperatur (T1):	Temperature (T1):					
Temperatur (T2):	Temperature (T2):					
Grenzwert:	Limit Value:					
Ergebnis:	Result:					
Der Dichtheitstest nach § 1065.345 wurde 	Leak-Check EPA CRF40 § 1065.345 					
Fehler beim schreiben der Daten	Error while saving data					
Daten gespeichert!	Saved data!					
OK	OK	
Messgerät / Seriennummer:	Analyzer / Serial number:
Aktive Sample Point:	active Sample Point:
Bearbeiter:	Operator:
--------------------------------------------------------------------------
[END]
--------------------------------------------------------------------------
---------------------------------------------------------------------------
[REZEPT LADEN]	[45]
--------------------------------------------------------------------------
Laden	Load					
Fertig	Done					
Rezepte:	Recipes:					
FT-IR Rezept wechsel	Change FTIR Recipe					
AK Konfiguration	Configuration for AK					
--------------------------------------------------------------------------
[END]
--------------------------------------------------------------------------
---------------------------------------------------------------------------
[REZEPTWECHSEL]	[46]
--------------------------------------------------------------------------
Rezeptwechsel wird durchgeführt	Performing recipe exchange					
Neues Rezept	New Recipe					
Rezept - Wechsel	Change Recipe					
Rezeptwechsel gestartet:	Change Recipe startet:					
Rezept wurde geladen	Recipe loaded					
Run - Mode verlassen	Stop Run - Mode					
Fehler Rezeptwechsel	Error Change Recipe					
Fehlercode:	Errorcode:					
Fehlercode: Keine Kommunikation mit MG 2000	Errorcode: No Communication MG 2000		
Rezeptwechsel üerprüfen!!!	Check Change of Recipe!!!					
MG 2000 bereit!	MG 2000 ready!					
Starten	Starting					
MG 2000 befindet CR sich nicht im Run - Mode!	MG 2000 is not CR in Run - Mode!	
MG reagiert nicht!	MG is not responding!					
--------------------------------------------------------------------------
[END]
--------------------------------------------------------------------------
---------------------------------------------------------------------------
[DIAG ZYKLUSZEIT]	[47]
--------------------------------------------------------------------------
Diagnose Zykluszeit	Diagnosis Cycle Time					
Fertig	Done					
Messdaten	Measured Data					
ToolWeb	ToolWeb					
AK - Extern	AK - External					
--------------------------------------------------------------------------
[END]
--------------------------------------------------------------------------
---------------------------------------------------------------------------
[EPA KONTROLLE PARAMETER]	[48]
--------------------------------------------------------------------------
Parameter Kontrolle	Control Parameters					
Stufen Tabelle	List of Points					
Inlet Gas:	Inlet Gas:					
OK	OK					
ABBRECHEN	Cancel					
Kontrolle	Control					
Bitte	Please					
Warten	Wait					
--------------------------------------------------------------------------
[END]
--------------------------------------------------------------------------
---------------------------------------------------------------------------
[KONFIG GASTEILER]	[49]
--------------------------------------------------------------------------
Konfiguration Linearity Verification	Configuration Linearity Verification					
Gasteiler Einstellungen	Setting Gasdivider					
Gasteiler:	Gasdivider:					
Stufen:	Points:					
Gasteiler Type:	Gasdivider Type:					
Status:	Status:					
Anforderung	Connect					
Freigabe	Disconnect					
Druck CG zu Gasteiler:	Pressure CG to Gasdivider:					
Störung Kommunikation	Error Communication					
Pressure carrier gas	Pressure carrier gas					
Pressure diluted gas	Pressure diluted gas					
Outlet Pressure	Outlet Pressure					
SNOX before SAIRS	NOX before SAIR					
IP-Adresse:	IP Adress:					
Port:	Port:					
Einstellungen Lin-Verification	Settings Lin-Verification					
Stufen Tabelle	List of Points					
Stufen Abfragen	Scan Points					
SPEICHERN	Save					
Komponente:	Component:					
Konzentration:	Concentration:					
Summenformel:	Formula:					
Prüfgas in:	Calibrationgas in:					
Anzahl Stufen:	Number of Points:					
Zeitdauer pro Stufe:	Duration pro Point:					
Max Fehler (Sollwert):	Max Error (target value):					
Bearbeiter:	Operator:					
Kalibrator:	Calibrator:					
Inlet Gas:	Inlet Gas:					
LinVerification	LinVerification					
LNI Digital	LNI Digital					
LNI Analoge	LNI Analoge					
AVL Gasteiler	AVL Gasdivider					
Gasteiler CR Keine Anforderung! CR Mit manuellen LIN-Check weiter?	Gasdivider CR Not connected! CR Continue with manual LIN-Check?					
Gasteiler CR Keine Anforderung!	Gasdivider CR Not connected!					
JA	YES					
NEIN	NO					
Bitte	Please					
Warten	Wait					
OK	OK					
Konfiguration Gasteiler	Configuration Gasdivider					
Einstellungen Lin-Check / Auto-Lin	Settings Lin-Check / Auto Lin					
FTIR-LIN	FTIR-LIN					
Polynomkoeffizienten CR FT-IR	Polynomcoefficients CR FT-IR					
Anzahl Mittelwerte:	Average:					
Messbereich:	Range:					
Max Fehler (Endwert):	Max Error (Endpoint):					
Max Fehler (Deviation):	Max Error (Deviation):					
Prüfgas:	Calibration Gas:					
TCP Verbindung aktiv	TCP Connection activ					
Druck CG zu Gasteiler:	Pressure to Gasdivider:					
Störung Gasteiler	Error Gasdivider					
Gasteiler und Anlage werden gespült	flushing Gasdivider and Device					
--------------------------------------------------------------------------
[END]
--------------------------------------------------------------------------
---------------------------------------------------------------------------
[KALIBRIERDATEN LADEN]	[50]
--------------------------------------------------------------------------
Kalibrierdaten laden	Load Calibration Data
Kalibrierung für Komponente	Calibration for Component
Spanfaktor neu	Spanfactor new
Spanfaktor alt 	Spanfactor old 
Offset neu	Offset new
Offset alt	Offset old
Rezept stimmt nicht überein!	Recipe is not the same!
Fortsetzen	Continue
Abbrechen	Abort
 konnte nicht gefunden werden	 could not be found
Fehler Kommunikation mit CR MG 2000 Software	Error communication CR MG 2000 Software
Es wurden NICHT alle Daten  CR vollständig übertragen.	Not EVERY data  CR transmitted completely.
Datenübertragung erfolgreich beendet.	Transmission of data successfully finished.
--------------------------------------------------------------------------
[END]
--------------------------------------------------------------------------
---------------------------------------------------------------------------
[KONTROLLE PARAMETER VOR LIN]	[51]
--------------------------------------------------------------------------
Parameter Kontrolle	Control Parameters					
Stufen Tabelle	List of Points					
Inlet Gas:	Inlet Gas:					
OK	OK					
ABBRECHEN	Cancel					
Kontrolle	Control					
Bitte	Please					
Warten	Wait					
--------------------------------------------------------------------------
[END]
--------------------------------------------------------------------------
---------------------------------------------------------------------------
[KONFIGURATION KALIBRIERGASE]	[52]
--------------------------------------------------------------------------
Konfiguration Kalibriergase	Config Calibration gas	xxx				
Definition Kalibriergase	Calibration gas configuration	xxx				
Name	Name	xxx				
Konzentration	Concentration	xxx				
Einheit	Unit	xxx				
Messbereich	Range	xxx				
Aufschaltung Kalibriergas	Calibration Gas Offering					
Kalibriergas	Calibrationgas					
Aufschaltpunkt	CalGas over					
Analysator	Analyzer					
Filterblock	Filterblock					
Analysator direkt	Analyzer directly					
PNS	PNS					
Stickstoff	Nitrogen					
--------------------------------------------------------------------------
[END]
--------------------------------------------------------------------------
---------------------------------------------------------------------------
[INTERFERENCE VERIFICATION]	[53]
--------------------------------------------------------------------------
Anderer Test läuft gerade. CR Bitte etwas Geduld.	Another Test is running. CR Please wait a moment.
Querempfindlichkeitsnachweis 1065.366	Interference Verification 1065.366
Einstellungen	Settings					
Grafik	Graphic					
Bearbeiter:	Operator:					
Komponente:	Component:					
Konzentration	Concentration					
Abweichung	Deviaton					
H2O - Soll	H2O - Set					
Fehler Kommunikaton HovaCal	Error Communication HovaCal					
H2O Konz. erreicht	H2O Conc. Reached					
Komponente Konz. erreicht	Component Conc. Reached					
Auswertung	Evaluation					
Wert Dry	Value Dry					
Wert Wet	Value Wet					
Abbrechen	Cancel					
Wert Dry berechnet	Value Dry Calculated					
Pfad:	Path:					
Speichern	Save					
Laden	Load					
Graph löschen	Clear Graph					
Komponente	Component					
Protokolleinstellungen	Protocol Settings					
Dry Speichern und Wet aufschalten?	Save Dry and Switch on Wet					
Ja	Yes					
Nein	No					
Wert überschreiben?	Overwrite Value?					
Konzentration Wet gespeichert	Concentration Wet Saved					
Test gestoppt!	Test stopped!					
Fehler HovaCal CR Test abgebrochen!	Error HovaCal  CR Test stopped!					
Test Beendet	Test finished					
Test Initialisiert	Test initialized
Stabilisierungszeit abwarten	Wait for stabilization time
Aufzeichnung gestartet: Mittelwert über 30 Sekunden bilden	Recording started: averaging over 30 seconds
Werte aufgezeichnet	Values ??recorded
Test abgebrochen	Test canceled
Fehler beim Schreiben der Daten!	Error write data!					
Daten gespeichert!	Data stored!					
Test Initialisieren	Test Dry initialized					
Punkt Dry aufschalten. CR Warten bis Zielkonzentration erreicht ist	Switch On Point Dry. CR Wait till target concentration is reached					
Konzentration erreicht. CR Mittelwert aus 30 Sekunden bilden CR Bitte Warten	Concentration reached. CR Wait for average of 30 seconds					
Wert Dry bereit zum Aufzeichnen	Value Dry ready  for record					
Test Wet initialisiert	Test Wet initialized					
Punkt Wet aufschalten CR Warten bis Zielkonzentration erreicht ist	Switch On Point Wet. CR Wait till target concentration is reached					
Wert Wet bereit zum aufzeichnen	Value Wet ready for record					
Protokoll	Protocol					
Beenden	Stop					
Spülen	Flush					
Die Anlage wird für 30 Sekunden gespült	Flush the system for 30 seconds					
Soll - Konzentration:	Target - concentratoin					
Ist - Konzentration Trocken:	Actual - concentration Dry:					
Soll - H2O:	Setpoint - H2O:					
IST - H2O:	Actual H2O					
Ist - Konzentration Feucht:	Actual concentration Wet:					
Ist - Konzentration Feucht berechnet:	Actual concentration Wet calculated:					
Geforderte Genauigkeit:	Required interference:					
Bestanden	Passed					
Nicht bestanden	Not passed					
Wert erhalten	value retrieved					
Seriennummer:	Serial number:
Allgemeine Einstellungen	General Settings
Test Einstellungen	Test Settings
Ergebnis	Result
Messgerät:	Analyzer:
Stabilisierungszeit	Stabilization time
Komponente 1:	Component 1:
Komponente 2:	Component 2:
Komponente 3:	Component 3:
Gasflaschen Nr.:	Gas Bottle Nr.:
Konzentration:	Concentration:
Testgas Genauigkeit[%]:	Test gas accuracy [%]:
CG zu PNS	Cal Gas to PNS	Gaz d'étalonnage sur PNS				
CG zu Entnahmestelle	Cal Gas to Samplepoint	
CalGas	Cal Gas	Gaz d'étalonnage				
Messen	Measure	Mesure		
Interferenten	Interferents
Testdauer	Test duration
Daten löschen	Clear Data
Flussgewichteter CR Mittelwert	Flow Weighted CR Mean
Einheit	Unit
Zeit	Time
Komponente 1 CR Wert	Component 1 CR Value
Komponente 2 CR Wert	Component 2 CR Value
Komponente 3 CR Wert	Component 3 CR Value
max. Flussgewichteter Mittelwert	max. Flow Weighted Mean:
Bestanden	Passed
NICHT Bestanden	NOT Passed
PDF erstellen	Print to PDF
Querempfindlichkeit:	Interference:
Grenze:	Limit:
max. Fehlergrenze:	max. Deviation Limit:
max. Fehlergrenze	max. Deviation Limit
--------------------------------------------------------------------------
[END]
--------------------------------------------------------------------------
---------------------------------------------------------------------------
[INTERFERENCE VERIFICATION 375]	[54]
--------------------------------------------------------------------------
Anderer Test läuft gerade. CR Bitte etwas Geduld.	Another Test is running. CR Please wait a moment.
Querempfindlichkeitsnachweis 1065.375	Interference Verification 1065.375
Einstellungen	Settings					
Grafik	Graphic					
Bearbeiter:	Operator:					
Komponente:	Component:					
Konzentration	Concentration					
Abweichung	Deviaton					
H2O - Soll	H2O - Set					
Fehler Kommunikaton HovaCal	Error Communication HovaCal					
H2O Konz. erreicht	H2O Conc. Reached					
Komponente Konz. erreicht	Component Conc. Reached					
Auswertung	Evaluation					
Wert Dry	Value Dry					
Wert Wet	Value Wet					
Abbrechen	Cancel					
Wert Dry berechnet	Value Dry Calculated					
Pfad:	Path:					
Speichern	Save					
Laden	Load					
Graph löschen	Clear Graph					
Komponente	Component					
Protokolleinstellungen	Protocol Settings					
Dry Speichern und Wet aufschalten?	Save Dry and Switch on Wet					
Ja	Yes					
Nein	No					
Wert überschreiben?	Overwrite Value?					
Konzentration Wet gespeichert	Concentration Wet Saved					
Test gestoppt!	Test stopped!					
Fehler HovaCal CR Test abgebrochen!	Error HovaCal  CR Test stopped!					
Test Beendet	Test finished					
Test Initialisiert	Test initialized
Stabilisierungszeit abwarten	Wait for stabilization time
Aufzeichnung gestartet: Mittelwert über 30 Sekunden bilden	Recording started: averaging over 30 seconds
Werte aufgezeichnet	Values ??recorded
Test abgebrochen	Test canceled
Fehler beim Schreiben der Daten!	Error write data!					
Daten gespeichert!	Data stored!					
Test Initialisieren	Test Dry initialized					
Punkt Dry aufschalten. CR Warten bis Zielkonzentration erreicht ist	Switch On Point Dry. CR Wait till target concentration is reached					
Konzentration erreicht. CR Mittelwert aus 30 Sekunden bilden CR Bitte Warten	Concentration reached. CR Wait for average of 30 seconds					
Wert Dry bereit zum Aufzeichnen	Value Dry ready  for record					
Test Wet initialisiert	Test Wet initialized					
Punkt Wet aufschalten CR Warten bis Zielkonzentration erreicht ist	Switch On Point Wet. CR Wait till target concentration is reached					
Wert Wet bereit zum aufzeichnen	Value Wet ready for record					
Protokoll	Protocol					
Beenden	Stop					
Spülen	Flush					
Die Anlage wird für 30 Sekunden gespült	Flush the system for 30 seconds					
Soll - Konzentration:	Target - concentratoin					
Ist - Konzentration Trocken:	Actual - concentration Dry:					
Soll - H2O:	Setpoint - H2O:					
IST - H2O:	Actual H2O					
Ist - Konzentration Feucht:	Actual concentration Wet:					
Ist - Konzentration Feucht berechnet:	Actual concentration Wet calculated:					
Geforderte Genauigkeit:	Required interference:					
Bestanden	Passed					
Nicht bestanden	Not passed					
Wert erhalten	value retrieved					
Seriennummer:	Serial number:
Allgemeine Einstellungen	General Settings
Test Einstellungen	Test Settings
Ergebnis	Result
Messgerät:	Analyzer:
Stabilisierungszeit	Stabilization time
Komponente 1:	Component 1:
Komponente 2:	Component 2:
Komponente 3:	Component 3:
Gasflaschen Nr.:	Gas Bottle Nr.:
Konzentration:	Concentration:
Testgas Genauigkeit[%]:	Test gas accuracy [%]:
CG zu PNS	Cal Gas to PNS	Gaz d'étalonnage sur PNS				
CG zu Entnahmestelle	Cal Gas to Samplepoint	
CalGas	Cal Gas	Gaz d'étalonnage				
Messen	Measure	Mesure		
Interferenten	Interferents
Testdauer	Test duration
Daten löschen	Clear Data
Flussgewichteter CR Mittelwert	Flow Weighted CR Mean
Einheit	Unit
Zeit	Time
Komponente 1 CR Wert	Component 1 CR Value
Komponente 2 CR Wert	Component 2 CR Value
Komponente 3 CR Wert	Component 3 CR Value
max. Flussgewichteter Mittelwert	max. Flow Weighted Mean:
Bestanden	Passed
NICHT Bestanden	NOT Passed
PDF erstellen	Print to PDF
Querempfindlichkeit:	Interference:
Grenze:	Limit:
Komponente CR Wert	Component CR Value
--------------------------------------------------------------------------
[END]
--------------------------------------------------------------------------
---------------------------------------------------------------------------
[INTERFERENCE PROTOKOLL 375]	[55]
--------------------------------------------------------------------------
Einstellungen	Settings					
Grafik	Graphic					
Bearbeiter:	Operator:					
Komponente:	Component:					
Konzentration	Concentration					
Abweichung	Deviaton					
H2O - Soll	H2O - Set					
Fehler Kommunikaton HovaCal	Error Communication HovaCal					
H2O Konz. erreicht	H2O Conc. Reached					
Komponente Konz. erreicht	Component Conc. Reached					
Auswertung	Evaluation					
Wert Dry	Value Dry					
Wert Wet	Value Wet					
Abbrechen	Cancel					
Wert Dry berechnet	Value Dry Calculated					
Pfad:	Path:					
Speichern	Save					
Laden	Load					
Graph löschen	Clear Graph					
Komponente	Component					
Protokolleinstellungen	Protocol Settings					
Dry Speichern und Wet aufschalten?	Save Dry and Switch on Wet					
Ja	Yes					
Nein	No					
Wert überschreiben?	Overwrite Value?					
Konzentration Wet gespeichert	Concentration Wet Saved					
Test gestoppt!	Test stopped!					
Fehler HovaCal CR Test abgebrochen!	Error HovaCal  CR Test stopped!					
Test Beendet	Test finished					
Test Initialisiert	Test initialized
Stabilisierungszeit abwarten	Wait for stabilization time
Aufzeichnung gestartet: Mittelwert über 30 Sekunden bilden	Recording started: averaging over 30 seconds
Werte aufgezeichnet	Values ??recorded
Test abgebrochen	Test canceled
Fehler beim Schreiben der Daten!	Error write data!					
Daten gespeichert!	Data stored!					
Test Initialisieren	Test Dry initialized					
Punkt Dry aufschalten. CR Warten bis Zielkonzentration erreicht ist	Switch On Point Dry. CR Wait till target concentration is reached					
Konzentration erreicht. CR Mittelwert aus 30 Sekunden bilden CR Bitte Warten	Concentration reached. CR Wait for average of 30 seconds					
Wert Dry bereit zum Aufzeichnen	Value Dry ready  for record					
Test Wet initialisiert	Test Wet initialized					
Punkt Wet aufschalten CR Warten bis Zielkonzentration erreicht ist	Switch On Point Wet. CR Wait till target concentration is reached					
Wert Wet bereit zum aufzeichnen	Value Wet ready for record					
Protokoll	Protocol					
Beenden	Stop					
Spülen	Flush					
Die Anlage wird für 30 Sekunden gespült	Flush the system for 30 seconds					
Soll - Konzentration:	Target - concentratoin					
Ist - Konzentration Trocken:	Actual - concentration Dry:					
Soll - H2O:	Setpoint - H2O:					
IST - H2O:	Actual H2O					
Ist - Konzentration Feucht:	Actual concentration Wet:					
Ist - Konzentration Feucht berechnet:	Actual concentration Wet calculated:					
Geforderte Genauigkeit:	Required interference:					
Bestanden	Passed					
Nicht bestanden	Not passed					
Wert erhalten	value retrieved					
Seriennummer:	Serial number:
Allgemeine Einstellungen	General Settings
Test Einstellungen	Test Settings
Ergebnis	Result
Messgerät:	Analyzer:
Stabilisierungszeit	Stabilization time
Komponente 1:	Component 1:
Komponente 2:	Component 2:
Komponente 3:	Component 3:
Gasflaschen Nr.:	Gas Bottle Nr.:
Konzentration:	Concentration:
Testgas Genauigkeit[%]:	Test gas accuracy [%]:
CG zu PNS	Cal Gas to PNS	Gaz d'étalonnage sur PNS				
CG zu Entnahmestelle	CG to Samplepoint
CalGas	Cal Gas	Gaz d'étalonnage				
Messen	Measure	Mesure		
Interferenten	Interferents
Testdauer	Test duration
Daten löschen	Clear Data
Flussgewichteter CR Mittelwert	Flow Weighted CR Mean
Einheit	Unit
Zeit	Time
Komponente CR Wert	Component CR Value
Komponente 1 CR Wert	Component 1 CR Value
Komponente 2 CR Wert	Component 2 CR Value
Komponente 3 CR Wert	Component 3 CR Value
max. Flussgewichteter Mittelwert	max. Flow Weighted Mean:
Bestanden	Passed
NICHT Bestanden	NOT Passed
PDF erstellen	Print to PDF
Querempfindlichkeit:	Interference:	
Datum & Zeit:	Date & Time:
Bearbeiter:	Operator:
Rezept / Methode:	Recipe / Method:
Gasflaschennummer Interferent 1:	Gas Bottle Nr. Interferent 1:
Gasflaschennummer Interferent 2:	Gas Bottle Nr. Interferent 2:
Gasflaschennummer Interferent 3:	Gas Bottle Nr. Interferent 3:
Gasflaschennummer Interferent 4:	Gas Bottle Nr. Interferent 4:
Genauigkeit Interferent 1:	Accuracy Interferent 1:
Genauigkeit Interferent 2:	Accuracy Interferent 2:
Genauigkeit Interferent 3:	Accuracy Interferent 3:
Genauigkeit Interferent 4:	Accuracy Interferent 4:
Konzentration Interferent 1:	Concentration Interferent 1:
Konzentration Interferent 2:	Concentration Interferent 2:
Konzentration Interferent 3:	Concentration Interferent 3:
Konzentration Interferent 4:	Concentration Interferent 4:
Grenze:	Limit:	
Anlage:	Measuring Device:
--------------------------------------------------------------------------
[END]
--------------------------------------------------------------------------
---------------------------------------------------------------------------
[INTERFERENCE PROTOKOLL]	[56]
--------------------------------------------------------------------------
Einstellungen	Settings					
Grafik	Graphic					
Bearbeiter:	Operator:					
Komponente:	Component:					
Konzentration	Concentration					
Abweichung	Deviaton					
H2O - Soll	H2O - Set					
Fehler Kommunikaton HovaCal	Error Communication HovaCal					
H2O Konz. erreicht	H2O Conc. Reached					
Komponente Konz. erreicht	Component Conc. Reached					
Auswertung	Evaluation					
Wert Dry	Value Dry					
Wert Wet	Value Wet					
Abbrechen	Cancel					
Wert Dry berechnet	Value Dry Calculated					
Pfad:	Path:					
Speichern	Save					
Laden	Load					
Graph löschen	Clear Graph					
Komponente	Component					
Protokolleinstellungen	Protocol Settings					
Dry Speichern und Wet aufschalten?	Save Dry and Switch on Wet					
Ja	Yes					
Nein	No					
Wert überschreiben?	Overwrite Value?					
Konzentration Wet gespeichert	Concentration Wet Saved					
Test gestoppt!	Test stopped!					
Fehler HovaCal CR Test abgebrochen!	Error HovaCal  CR Test stopped!					
Test Beendet	Test finished					
Test Initialisiert	Test initialized
Stabilisierungszeit abwarten	Wait for stabilization time
Aufzeichnung gestartet: Mittelwert über 30 Sekunden bilden	Recording started: averaging over 30 seconds
Werte aufgezeichnet	Values ??recorded
Test abgebrochen	Test canceled
Fehler beim Schreiben der Daten!	Error write data!					
Daten gespeichert!	Data stored!					
Test Initialisieren	Test Dry initialized					
Punkt Dry aufschalten. CR Warten bis Zielkonzentration erreicht ist	Switch On Point Dry. CR Wait till target concentration is reached					
Konzentration erreicht. CR Mittelwert aus 30 Sekunden bilden CR Bitte Warten	Concentration reached. CR Wait for average of 30 seconds					
Wert Dry bereit zum Aufzeichnen	Value Dry ready  for record					
Test Wet initialisiert	Test Wet initialized					
Punkt Wet aufschalten CR Warten bis Zielkonzentration erreicht ist	Switch On Point Wet. CR Wait till target concentration is reached					
Wert Wet bereit zum aufzeichnen	Value Wet ready for record					
Protokoll	Protocol					
Beenden	Stop					
Spülen	Flush					
Die Anlage wird für 30 Sekunden gespült	Flush the system for 30 seconds					
Soll - Konzentration:	Target - concentratoin					
Ist - Konzentration Trocken:	Actual - concentration Dry:					
Soll - H2O:	Setpoint - H2O:					
IST - H2O:	Actual H2O					
Ist - Konzentration Feucht:	Actual concentration Wet:					
Ist - Konzentration Feucht berechnet:	Actual concentration Wet calculated:					
Geforderte Genauigkeit:	Required interference:					
Bestanden	Passed					
Nicht bestanden	Not passed					
Wert erhalten	value retrieved					
Seriennummer:	Serial number:
Allgemeine Einstellungen	General Settings
Test Einstellungen	Test Settings
Ergebnis	Result
Stabilisierungszeit	Stabilization time
Komponente 1:	Component 1:
Komponente 2:	Component 2:
Komponente 3:	Component 3:
Gasflaschen Nr.:	Gas Bottle Nr.:
Konzentration:	Concentration:
Testgas Genauigkeit[%]:	Test gas accuracy [%]:
CG zu PNS	Cal Gas to PNS	Gaz d'étalonnage sur PNS				
CG zu Entnahmestelle	CG to Samplepoint
CalGas	Cal Gas	Gaz d'étalonnage				
Messen	Measure	Mesure		
Interferenten	Interferents
Testdauer	Test duration
Daten löschen	Clear Data
Flussgewichteter CR Mittelwert	Flow Weighted CR Mean
Einheit	Unit
Zeit	Time
Komponente 1 CR Wert	Component 1 CR Value
Komponente 2 CR Wert	Component 2 CR Value
Komponente 3 CR Wert	Component 3 CR Value
max. Flussgewichteter Mittelwert	max. Flow Weighted Mean:
Bestanden	Passed
NICHT Bestanden	NOT Passed
PDF erstellen	Print to PDF
Querempfindlichkeit:	Interference:	
Datum & Zeit:	Date & Time:
Bearbeiter:	Operator:
Rezept / Methode:	Recipe / Method:
Gasflaschennummer Interferent 1:	Gas Bottle Nr. Interferent 1:
Gasflaschennummer Interferent 2:	Gas Bottle Nr. Interferent 2:
Gasflaschennummer Interferent 3:	Gas Bottle Nr. Interferent 3:
Gasflaschennummer Interferent 4:	Gas Bottle Nr. Interferent 4:
Genauigkeit Interferent 1:	Accuracy Interferent 1:
Genauigkeit Interferent 2:	Accuracy Interferent 2:
Genauigkeit Interferent 3:	Accuracy Interferent 3:
Genauigkeit Interferent 4:	Accuracy Interferent 4:
Konzentration Interferent 1:	Concentration Interferent 1:
Konzentration Interferent 2:	Concentration Interferent 2:
Konzentration Interferent 3:	Concentration Interferent 3:
Konzentration Interferent 4:	Concentration Interferent 4:
Grenze:	Limit:
Anlage:	Measuring Device:
Messgerät:	Analyzer:
--------------------------------------------------------------------------
[END]
--------------------------------------------------------------------------
---------------------------------------------------------------------------
[INTERFERENCE HILFE]	[57]
--------------------------------------------------------------------------
Toleranzbereich für Start der Messaufzeichung. Betrifft Komponenten- und H²O Konzentration. Empfohlen 5%. Bei dem Wert 0 wird eine 10 Sekunden Zeitverzögerung angewandt.	Tolerance range for start of measurement recording.Concerns component and H²O concentration. Recommended 5%. If the value is 0, a 10 seconds time delay.					
--------------------------------------------------------------------------
[END]
--------------------------------------------------------------------------
---------------------------------------------------------------------------
[SPUELEN]	[58]
--------------------------------------------------------------------------
Spülen der Anlage	Flush the system					
--------------------------------------------------------------------------
[END]
--------------------------------------------------------------------------
---------------------------------------------------------------------------
[GASTEILER SPUELEN]	[59]
--------------------------------------------------------------------------
Gasteiler Spülen ?	Flush Gasdivider					
Spülen	Flush					
NICHT Spülen	Don't Flush					
ABBRECHEN	Cancel					
Spüldauer	Flushtime					
Gasteiler Spülen	Flush gas divider					
--------------------------------------------------------------------------
[END]
--------------------------------------------------------------------------
---------------------------------------------------------------------------
[GASTEILER KALIBRIEREN]	[60]
--------------------------------------------------------------------------
Status Gasteiler	Status Gasdivider					
Nullpunkt-Kalibrieren	Zeropoint Calibration					
Endpunkt-Kalibrieren	Endpoint Calibration					
Weiter zum Lin-Check	Continue to Lin-Check					
ABBRECHEN	CANCEL					
Kalibrieren?	Calibration?					
Kalibrieren (über Gasteiler)	Calibration (over Gasdivider)					
--------------------------------------------------------------------------
[END]
--------------------------------------------------------------------------
---------------------------------------------------------------------------
[SENSOR KONFIGURATION]	[61]
--------------------------------------------------------------------------
Sensor Konfiguration	Sensor Configuration					
Durchfluss FTIR:	Flow FTIR:					
Sensor	Sensor					
Druck CG PMD:	Pressure CG PMD:					
Druck Ausgang:	Pressure Outlet:					
Umgebungsdruck:	Ambient Pressure:					
Druck CG:	Pressure CG:					
Druck FTIR IAG:	Pressure FTIR IAG:					
Druck Kalter Block:	Pressure Cold Block:					
Durchfluss PMD:	Flow PMD:					
Istwert	Actual Value					
Kalibrierwert	Calibration Value					
Rohwert	Raw Value					
Speichern	Save					
Abbrechen	Cancel					
--------------------------------------------------------------------------
[END]
--------------------------------------------------------------------------
---------------------------------------------------------------------------
[KONFIGURATION PMA]	[62]
--------------------------------------------------------------------------
Konfiguration PMD	Configuration PMD					
Hilfsgrößen:	Auxiliary variable:					
Temperatur:	Temperature:					
Stellgröße:	Control value:					
Temperatur Detektor:	Temperature Detector:					
Temperatur Regler:	Temperature Controller:					
End-Punktkalibrierung	End-Point Calibration					
0-Punkt Kalibrierung	Zero-Point Calibration					
STATUS	STATUS					
Ausfall	Failure					
Funktionskontrolle	Functional check					
Wartungsbedarf	Maintenance					
Roh Wert O2:	Raw Value O2:					
Druck:	Pressure:					
Druck Detektor:	Pressure Detector:					
Kalibrierdaten	Calibrationdata					
Aufschaltung Kalibriergas	Calibration Gas Offering					
Kalibriergas	Calibrationgas					
Aufschaltpunkt	CalGas over					
Analysator	Analyzer					
--------------------------------------------------------------------------
[END]
--------------------------------------------------------------------------
---------------------------------------------------------------------------
[KALIBRIERDATEN]	[63]
--------------------------------------------------------------------------
Kalibrierdaten	Calibration Data					
0-Punkt	Zero-point					
Speichern	Save					
Beenden	Cancel					
End-Punkt	End-point					
0-Punkt Toleranz [abs]	Zero-Point Tolerance [abs]					
End-Punkt Toleranz [%]	End-point Tolerance [%]					
Aufschaltzeit Auto-KAL [sec]	Delivery Time Auto-KAL [sec]					
letzte CR Kalibrierung	last CR Calibration					
Grund- CR kalibrierung	Ground- CR calibration					
--------------------------------------------------------------------------
[END]
--------------------------------------------------------------------------
---------------------------------------------------------------------------
[KONFIGURATION FID]	[64]
--------------------------------------------------------------------------
Konfiguration FID	Configuration FID					
Kalibrierdaten	Calibrationdata					
Grafik	Graphic					
Hilfsgrößen:	Auxiliary variable:					
Temperaturen:	Temperature:					
Stellgröße:	Control Value:					
Temperatur Detektor:	Temperature Detector:					
Temperatur Messgaseingang:	Temperature Measuring gas inlet:					
Temperatur Flamme:	Temperature Flame:					
Druck:	Pressure:					
Druck Brennluft:	Pressure Combustion Air:					
Druck Brenngas H2/He:	Pressure H2/He:					
Druck Messgaseingang:	Pressure Measuring Inlet:					
Druck Messgasausgang:	Pressure Measuring Outlet:					
0-Punkt Kalibrierung	Zero-Point Calibration					
End-Punkt Kalibrierung	End-Point Calibration					
STATUS	STATUS					
FID kalibrieren mit:	 FID Calibration with:					
Ausfall	Failure					
Funktionskontrolle	Functional check					
Wartungsbedarf	Maintenance					
Durchfluss:	Flow:					
Aufschaltung Kalibriergas	Calibration Gas Offering					
Kalibriergas	Calibrationgas					
Aufschaltpunkt	CalGas over					
Analysator	Analyzer					
Protokoll gespeichert	Protocol saved					
Einstellungen geändert	Settings changed					
Test abgebrochen	Check aborted					
--------------------------------------------------------------------------
[END]
--------------------------------------------------------------------------
---------------------------------------------------------------------------
[ABB MANUELL KALIBRIEREN]	[65]
--------------------------------------------------------------------------
Kalibrieren Endpunkt NMHC	Calibration End-point NMHC					
0-Punkt Kalibrierung CH4	Calibration Zero-point CH4					
0-Punkt Kalibrierung THC	Calibration Zero-point THC					
0-Punkt Kalibrierung NMHC	Calibration Zero-point NMHC					
Endpunkt Kalibrierung CH4	Calibration End-point CH4					
Endpunkt Kalibrierung THC	Calibration End-point THC					
Kalibrieren gestartet	Start Calibration					
Kalibrierwerte wurden kopiert	Calibration value are copied					
Kalibrierung mit TIMEOUT beendet	Calibration completed with TIMEOUT!					
Kalibrierung erfolgreich beendet	Calibration sucessfully completed					
Kalibrierwerte kopieren?:	Copy Calibration Values?:					
Wert ist im gültigen Bereich:	Value is in the valid range:					
Abbrechen	Cancel					
START	START					
Roh Wert THC:	Raw value THC:					
Kalibrationsgas	Calibrationgas					
Konzentration	Concentration					
Einheit	Unit					
Messbereich	Range					
--------------------------------------------------------------------------
[END]
--------------------------------------------------------------------------
---------------------------------------------------------------------------
[PMA MANUELL KALIBRIEREN]	[66]
--------------------------------------------------------------------------
End-Punkt Kalibrierung O2	Calibration End-point O2					
0-Punkt Kalibrierung O2	Calibration Zero-point O2					
Kalibrieren gestartet	Start Calibration					
Kalibrierwerte wurden kopiert	Calibration value are copied					
Kalibrierung mit TIMEOUT beendet	Calibration completed with TIMEOUT!					
Kalibrierung erfolgreich beendet	Calibration sucessfully completed					
Konzentration	Concentration					
Messbereich	Range					
Roh Wert O2:	Raw value O2:					
Wert im gültigen Bereich:	Value is in the valid range:					
START	START					
Abbrechen	Cancel					
--------------------------------------------------------------------------
[END]
--------------------------------------------------------------------------
---------------------------------------------------------------------------
[SPRACHAUSWAHL]	[67]
--------------------------------------------------------------------------
Bitte wählen Sie eine Sprache:	Please select a language:					
OK	OK					
Abbrechen	Cancel					
Deutsch						
English						
Français						
Italiano						
Castellano						
Polski						
--------------------------------------------------------------------------
[END]
--------------------------------------------------------------------------
---------------------------------------------------------------------------
[SYS LOG HISTORY]	[68]
--------------------------------------------------------------------------
SysLog History Anzeige	SysLog History Viewer					
System Log History	System Log History					
Aktualisieren	Refresh					
Ebene	Level					
Zeit	Time					
Typ	Type					
Sortierung	Sorting					
Richtung	Direction					
interne	internal					
PC History Laden	Load PC History					
cRIO History Laden	Load cRIO History					
Suche	Search					
Transparenz	Opacity					
--------------------------------------------------------------------------
[END]
--------------------------------------------------------------------------
---------------------------------------------------------------------------
[SYS LOG STATUS]	[69]
--------------------------------------------------------------------------
System Log Meldungen werden hier nur vorübergehend als Status angezeigt und dann in die History Datei geschrieben, und dient daher nur zum aktuellen Überblick. CR Bitte die SysLogHistorie öffnen für eine umfangreiche Recherche.	System Log messages are shown as Status only temporarely and stored into a History File, it shows only an actual overview. CR Please use SysLogHistorie for full research.					
--------------------------------------------------------------------------
[END]
--------------------------------------------------------------------------
---------------------------------------------------------------------------
[PNS UEBERSICHT]		[70]
--------------------------------------------------------------------------
PNS Anlagenübersicht	PNS Process chart	PNS Schéma Processus				
Anlagenübersicht PNS	Process chart PNS	Schéma Processus PNS				
Kommunikation gestört!	Communication Error!					
Druckluft Störung!	PNS error compressed air supply	PNS erreur sur arrivée d'air comprimée				
Probenahmesystem INAKTIV!	PNS deactivated!					
--------------------------------------------------------------------------
[END]
--------------------------------------------------------------------------
---------------------------------------------------------------------------
[CG TEST]	[71]
--------------------------------------------------------------------------
Cal Gas -Test	Cal Gas -Test					
Komponenten	Components					
Sollwerte	Setpoints					
Abweichung	Deviation					
Istwert	Actual CR Value					
Beenden	Close					
Cal Gas aufgeschaltet	Cal Gas switched on					
Prüfung läuft	Test running					
Aufschaltdauer	Cut-Off Time					
Prüfdauer	Testtime					
Cal Gas -Test 	Cal Gas -Test 					
 beendet	 finished					
Cal Gas -Test Fehlerhaft!	Cal Gas -Test failed!					
Cal Gas -Test in Ordnung!	Cal Gas -Test passed!					
Testgas - Messung	Cal Gas Check - Measuring					
max. CR Abweichung	max. CR Deviation					
Ist CR Abweichung	Ist CR Deviation					
--------------------------------------------------------------------------
[END]
--------------------------------------------------------------------------
---------------------------------------------------------------------------
[KONFIG CG CHECK]	[72]
--------------------------------------------------------------------------
Konfig Testgas	Config CG-Check					
Komponenten	Components					
Sollwerte	Setpoints					
max. Abweichung	max. Deviation					
über PNS	via PNS					
Span 1 durchführen	run Span 1					
Span 2 durchführen	run Span 2					
Span 3 durchführen	run Span 3					
Span 4 durchführen	run Span 4					
Span 5 durchführen	run Span 5					
Span 6 durchführen	run Span 6					
Span 7 durchführen	run Span 7					
Span 8 durchführen	run Span 8					
Span 9 durchführen	run Span 9					
Cal Gas O2 durchführen	run Cal Gas O2					
Pfad CalGas Test:	Path CalGas Test:					
Textname:	Filename:					
Aufschaltdauer	Cut-Off Time					
Prüfdauer	Testtime					
Mittelwertanzahl	Number Average					
Speichern	Save					
Beenden	Cancel					
START	START					
Auswertung	Result					
Analysator	Analyzer					
Prüfung läuft	Check is runing					
Cal Gas - Test 	Cal Gas - Check 					
 beendet	 finished					
Cal Gas - Test Fehlerhaft!	Cal Gas - Check failed!					
Cal Gas - Test in Ordnung!	Cal Gas - Check passed!					
Cal Gas aufgeschaltet	Cal Gas switched on					
Prüfdauer	Duration of Check					
Aufschaltdauer	Duration of Cut-Off					
--------------------------------------------------------------------------
[END]
--------------------------------------------------------------------------
---------------------------------------------------------------------------
[HOVA MAIN]	[73]
--------------------------------------------------------------------------
Gesamtdurchfluss	Total Flow	Flux Total				
--------------------------------------------------------------------------
[END]
--------------------------------------------------------------------------
---------------------------------------------------------------------------
[HORIBA GDC]	[74]
--------------------------------------------------------------------------
Horiba GDC	Horiba GDC					
Status	State					
Gas Konzentration	Gas Concentration					
Teilungsstufe (0-500)	Points (0-500)					
Konzentration	Concentration					
Formelzeichen Gas	Gas Formula					
Störung Kommunikation	Error Communication					
Störung Gasteiler	Error Gasdivider					
Exit	Exit					
Schnittstelle	Interface					
Start	Start					
--------------------------------------------------------------------------
[END]
--------------------------------------------------------------------------
---------------------------------------------------------------------------
[BACKUP]	[75]
--------------------------------------------------------------------------
Abbrechen	Cancel					
Backup Manager	Backup Manager					
Backup	Backup					
Kommunikation	Communication					
SysLog	SysLog					
Rezepte	recipies					
cRIO startup	cRIO startup					
cRIO KonfigIAG	cRIO KonfigIAG					
--------------------------------------------------------------------------
[END]
--------------------------------------------------------------------------
---------------------------------------------------------------------------
[SPAN FAKTOREN]	[76]
--------------------------------------------------------------------------
Konfiguration Spanfaktoren FT-IR	Configuration Spanfactors FT-IR					
Kalibrierung laden	Load Calibration					
in TXT speichern	save to TXT					
Beenden	Close					
Komponente	Component					
Rohwert FTIR	Raw Value FTIR					
Aktueller Wert	Actual Value					
Span	Span					
Offset	Offset					
--------------------------------------------------------------------------
[END]
--------------------------------------------------------------------------
---------------------------------------------------------------------------
[CG POPUP]	[77]
--------------------------------------------------------------------------
Konfiguration Kalibriergase	Config Calibration gas	xxx				
Definition Kalibriergase	Calibration gas configuration	xxx				
Name	Name	xxx				
Konzentration	Concentration	xxx				
Einheit	Unit	xxx				
Messbereich	Range	xxx				
Aufschaltung Kalibriergas	Calibration Gas Offering					
Kalibriergas	Calibrationgas					
Aufschaltpunkt	CalGas over					
Analysator	Analyzer					
Filterblock	Filterblock					
Analysator direkt	Analyzer directly					
PNS	PNS					
Stickstoff	Nitrogen					
--------------------------------------------------------------------------
[END]
--------------------------------------------------------------------------
---------------------------------------------------------------------------
[AUTO CALIBRATION]	[78]
--------------------------------------------------------------------------
TIMEOUT	TIMEOUT					
Auto Kalibrierung	Auto Calibration					
Zeit	Time					
Abbrechen	Cancel					
Hintergrund anfordern	Request background					
Hintergrund Abgebrochen! 	background aborted! 					
Messgerät reagiert nicht! 	FT-IR do not respond! 					
Vergleiche ob CO2 und H2O innerhalb Grenzen	Comparing if CO2 or H2O below limit					
Hintergrund NICHT gestartet! 	background not started! 					
H2O & CO2 zu hoch.	H2O or CO2 too high!					
Starte Hintergrund!	Start background!					
Hintergrund gestartet. Bitte Warten.	Background started. Please wait.					
Hintergrund NICHT gestartet! 	Background NOT started! 					
Hintergrund beendet.	Background finished!					
Hintergrund wurde wahrscheinlich nicht durchgefürht! 	Background was not completed successful! 					
Starte neuen Versuch	Start a new attempt!					
Kalibrierung FT-IR abgeschlossen	Finished taking background					
Anforderung Nullpunkt 	Request Zero-point 					
Kalibrierung Abgebrochen! 	Calibration aborted! 					
Störung steht an! 	Failure! 					
Nullgas wird Aufgeschaltet	Switch on Zero-point					
Nullpunkt konnte NICHT gestartet werden!	Zero-point could not be started					
Nullpunkt kalibrieren gestartet	Zero-point started					
Kalibriern Fehler! Deviation zu Hoch!	Calibration Error! Deviation to high!					
Nullpunkt Kalibrierung Abgebrochen	Zero-point calibration aborted!					
Nullpunkt Kalibrieren Erfolgreich beendet	Zero-pont calibration finished					
Fehler Nullpunkt-Kalibrieren	Error Zero-point calibration					
Kein Prüfgas für O2 vorhanden	No calibration gas for O2 available					
Kein Prüfgas für CH4 vorhanden	No calibration gas for CH4 available					
Kein Prüfgas für THC vorhanden	No calibration gas for TCH available					
Endpunkt	Endpoint					
(Konzentration: 	(Concentration: 					
Anforderung Endpunkt Kalibrieren	Request Endpoint Calibration					
Endpunkt kalibrieren gestartet	End-point calibration started					
Endpunkt konnte NICHT gestartet werden!	Zero-point could not be started					
Fehler Endpunkt-Kalibrieren	Error Endpoint-calibration					
Endpunkt Kalibrierung Abgebrochen	End-point calibration aborted!					
Endpunkt Kalibrieren Erfolgreich beendet	End-point calibration finished					
FTIR inaktiv! Background nicht gestartet!	FTIR inactive! Background not started!					
Es wurde nur 0-Punkt kalibriert	Only 0-Punkt calibrated					
Messbereich	Range					
wird kalibriert.	calibrating.					
Endpunkte kopiert	Endpoint copied					
PMA inaktiv!	PMA inactive!					
FID inaktiv!	FID inactive!					
--------------------------------------------------------------------------
[END]
--------------------------------------------------------------------------
---------------------------------------------------------------------------
[LIN V2]	[79]
--------------------------------------------------------------------------
Linearisierung FT-IR	Linearisation FT-IR	Linéarisation FT-IR				
Komponente:	Component:	Composant:				
Prüfgas Konzentration:	Gas Concentration:	Gaz Concentration:				
max.Fehler:	max. Deviation:	Ecart maxi:				
Mittelwerte:	Average:	Moyenne:				
Messgerät:	Instrument:	Instrument:				
Bearbeiter:	Authorised User:	Utilisateur Autorisé:				
LIN Datei laden	LIN Data load					
Polynomkoeffizienten	Polynomial coefficients	Polynome Coefficients:				
File Name:	File Name:	Nom de fichier:				
Pfad:	Path:	Chemin:				
Polynom AKTIV:	Polynom ACTIVE:	Polynome Activé:				
Polynom koeffizienten:	Polynom coefficients:	Polynome Coefficients:				
Istwert:	Actual Value:	Valeur actuelle:				
Standardabweichung:	Standard Deviation:	Deviation standard:				
Sollwerte	Setpoint	Point de consigne				
Istwert	Actual Value	Valeur actuelle				
Istwerte	Actual Values	Valeur actuelle				
Istwerte Abholen	Retrieve Actual Value	Retrouver Valeur Actuelle				
Istwerte Löschen	Delete Actual Value	Effacer la valeur actuel				
ALLES Löschen	Delete all	Tout effacer				
speichern	save	Sauvegarder				
Daten ermitteln	Determine data	Determiner les données				
LIN Anpassung	LIN Adjustment	LIN  Réglage				
Polynom-Ordnung	Polynom-Order	Polynome - commande				
Rohwerte	Raw Value	Valeur brut				
Linearisiert	Linearised Value	Valeur Linéarisée				
Sollwert	Setpoint	Point de consigne				
abs. Fehler (ppm)	abs. Deviation (ppm)	Deviation absolue (ppm)				
Gasteiler (ppm)	Gas divider (ppm)	Séparateur de gaz (ppm)				
Neues Polynom übernehmen	Set new Polynom 	Fixer le nouveau polynome				
Messgerät	Instrument	Instrument				
Kalibrator (Gasteiler)	Calibrator (Gas divider)	Etalonneur (diviseur de Gaz)				
Bearbeiter/in	Authorised User	Utilisateur Autorisé				
Komponente	Component	Composant				
Zeitstempel	Timestamp	Horodatage				
F_max gefordert (%)	Required max. Deviation (%)	Deviation Maxi requise (%) 				
F_max in %	Deviation max in %	Déviation Maxi en % 				
F_max in ppm	Deviation max in ppm	Déviation Maxi en ppm 				
Prüfgas Konzentration	Gas Concentration	Gaz Concentration				
Polynomkoeff.	Polynomcoeff.	Polynomecoeff.				
Vorschlag Ordnung	Proposition Order	Proposition de Commande				
Polynom OK	Polynom OK	Polynome OK				
abs. Fehler	abs. Deviation	Deviation abs.				
rel. Fehler	rel. Deviation	Deviation Rel.				
% v. Sollw.	% f. Setpoint	% de la valeur fixée				
Deviation	Deviation	Deviation				
Temp.Messzelle	Temp. Gascell	Temp. Gaz Cell.				
Druck Messzelle	Pressure Gascell	Press. Gaz Cell.				
Datum	Date	Date				
Uhrzeit	Time	Temps				
geford. max. Fehler (% v. Sollw.)	Required max. Deviation (%)	Deviation Maxi requise (%)				
erreichter max. Fehler (%)	Deviation max in %	Déviation Maxi en %				
erreichter max. Fehler (ppm)	Deviation max in ppm	Déviation Maxi en ppm				
Polynom-Ordnung	Polynom-Order	Polynome-commande 				
Ordnung festgelegt	Order selected					
geforderte Genauigkeit	max. Deviation	Ecart maxi				
erreicht	passed	passé				
NICHT erreicht	failed	Echoué				
Lin-Polynom:	Lin-Polynom:					
konstanter Koeff	constant Coeff					
linearer Koeff	linear Coeff					
quadrat. Koeff	2. Order					
3. Ordg	3. Order					
4. Ordg	4. Order					
Messw. roh	Raw Value	Valeur brut				
Linearisiert	linearized					
manuell	manual					
automatisch	automatic					
Fehler beim schreiben der Daten	Error write Data!					
Daten gespeichert!	Data stored!					
Neues Polynom gespeichert!	New Polynom stored!					
LIN Datei laden	LIN Data load					
Beenden	Cancel	Annuler				
TCP Verbindung aktiv	TCP connection active					
Störung Gasteiler	Error Gasdivider					
Einstellungen	Settings					
Daten generieren	Generate data					
Gasteilereinstellungen	Gasdivider settings					
Komponentenauswahl	Component settings					
Linearisierung allgemein	Linearity general					
Konzentration:	Concentration:					
Gasnummer:	Gasnumber:					
Stufenanzahl:	Number of Points:					
Zeit pro Stufe:	Duration pro Point:					
Max Fehler (vom Sollwert):	Max Error (target value):					
Bearbeiter:	Operator:					
Messgerät:	Calibrator:					
Konfiguration Linearity Verification	Configuration Linearity Verification					
Gasteiler Einstellungen	Setting Gasdivider					
Gasteiler:	Gasdivider:					
Stufen:	Points:					
Gasteiler Type:	Gasdivider Type:					
Anforderung	Connect					
Freigabe	Disconnect					
Druck CG zu Gasteiler:	Pressure CG to Gasdivider:					
Störung Kommunikation	Error Communication					
Druck Trägergas	Pressure carrier gas					
Druck Mixgas	Pressure diluted gas					
Druck Ausgang	Outlet Pressure					
SNOX bevor SAIRS	SNOX before SAIR					
IP-Adresse:	IP Adress:					
Port:	Port:					
Einstellungen Lin-Verification	Settings Lin-Verification					
Stufen Tabelle	List of Points					
Stufen Abfragen	Scan Points					
SPEICHERN	Save					
Komponente:	Component:					
Konzentration:	Concentration:					
Summenformel:	Formula:					
Prüfgas in:	Calibrationgas in:					
Anzahl Stufen:	Number of Points:					
Zeitdauer pro Stufe:	Duration pro Point:					
Max Fehler (Sollwert):	Max Error (target value):					
Bearbeiter:	Operator:					
Kalibrator:	Calibrator:					
Inlet Gas:	Inlet Gas:					
LinVerification	LinVerification					
LNI Digital	LNI Digital					
LNI Analoge	LNI Analoge					
AVL Gasteiler	AVL Gasdivider					
Gasteiler CR Keine Anforderung! CR Mit manuellen LIN-Check weiter?	Gasdivider CR Not connected! CR Continue with manual LIN-Check?					
Gasteiler CR Keine Anforderung!	Gasdivider CR Not connected!					
JA	YES					
NEIN	NO					
Bitte	Please					
Warten	Wait					
OK	OK					
Konfiguration Gasteiler	Configuration Gasdivider					
Einstellungen Lin-Check / Auto-Lin	Settings Lin-Check / Auto Lin					
FTIR-LIN	FTIR-LIN					
Polynomkoeffizienten CR FT-IR	Polynomcoefficients CR FT-IR					
Anzahl Mittelwerte:	Average:					
TCP Verbindung aktiv	TCP connection active					
Störung Gasteiler	Error Gasdivider					
Punkte umkehren	Reverse points					
ABBRECHEN	CANCEL					
Polynomkoeffizient:	Polynomial coefficients:					
Sollwert CR ---	Setpoint CR ---					
Linearisiert CR ---	Linearized CR ---					
Istwert CR ---	Actual value CR ---					
Sollwerte CR ---	Setpoints CR ---					
Istwerte CR ---	Actual values CR ---					
Rohwert CR ---	Raw Value CR ---					
abs.Fehler CR ---	abs.Error CR ---					
rel.Fehler CR % von Sollwert	rel.Error CR % from Setpoint					
Deviation CR ---	Deviation CR ---					
Temp. Messzelle CR in °C	Temp. Gascell CR in °C					
Druck Messzelle CR in atm	Pressure Gascell CR in atm					
Istwerte löschen	Delete Actual Value					
Alles löschen	Delete all					
Istwert abholen	Retrieve Value					
Istwert	Actual Value					
Rohwert	Raw Value					
Linearisierter Wert	Linearized Value					
Beschreibung der Grenzen:	Description of the limits					
Steigung (a1) Wert zwischen 0,99-1,01	Slope (a1) value between 0,99-1,01					
Steigung (a1)	Slope (a1)					
Achsenabschnitt (a0)	Intercept (a0)					
Labor: Wert <=  0,5% von der Kalibriergaskonzentration	laboratory: Value <= 0,5% of the gas concentration					
Feld: Wert <=  1% von der Kalibriergaskonzentration	field: Value <= 1% of the gas concentration					
Bestimmtheitsmaß (R²) Wert >= 0,998	Coefficient of determination (R²) Value >= 0,998					
Standart Fehler (SEE) Wert <= 1% von der Kalibriergaskonzentration	standard error of estimate (SEE) Value <= 1% of the gas concentration					
Linearitätsnachweis §1065.307	Linearity detection §1065.307					
Messwerte Analysator in ppm oder %	Analizer readings in ppm or %					
Vorgabewerte Kalibriergas  in ppm oder %	Setpoint Gasdivider in ppm or %					
Gasliste	Gaslist					
Namen	Name					
Aktiv	Active					
Linearisierung	Linearization					
Gasteiler spülen	rinse gasdivider					
Gasteiler mit EP spülen	rinse gasdivierder with EP					
Daten aufzeichnen	Record Data					
Kalibrierung	Calibration					
FT-IR kalibrieren	Calibrate FT-IR					
FID 0-Punkt kalibrieren	Calibrate FIP 0-Point					
FID Endpunkt kalibrieren	Calibrate FID E-Point					
PMD 0-Punkt kalibrieren	Calibrate PMD 0-Point					
PMD Endpunkt kalibrieren	Calibrate PMD E-Point					
Analysator	Analyser					
Status	State					
Status:	State:					
Parameterkontrolle:	Check Parameters:					
Kalibrierung:	Calibration:					
Aufschaltung Kalibriergas	Calibration Gas Offering					
Kalibriergas	Calibrationgas					
Aufschaltpunkt	CalGas over					
Konstante	Constant					
1.Ordnung	1.Order					
2.Ordnung	2.Order					
3.Ordnung	3.Order					
4.Ordnung	4.Order					
Max. Error in %:	Max. Error %:					
Kalibrier Optionen:	Calibration Options:					
Gasteiler	Gasdivider					
AutoKal	AutoCal					
Kalibrierung: 	Calibration: 					
Inaktiv	inactive	désactivé				
Aktiv	active	activé				
HovaCal Einstellungen	HovaCal Settings					
Allgemeine Einstellungen	General Settings					
Komponenten	Components					
Benutzerdef. Werte	Userdefined Values					
Vaporizer Ein	Vaporizer On					
Fehler Kommunikation CR Vaporizer	Error Communication CR Vaporizer					
Fehler Kommunikaton CR Betriebsdaten	Error Communication CR Operating Data					
Fehler Kommunikation CR Gase	Error Communication CR Gases					
Aktuelle Werte	Actual Values					
Gesamtdurchfluss:	Total Flow:					
Trägergas:	Carrier Gas:					
Durchfluss:	Flow:					
Drehzahl:	Speed of Rotation:					
Wasserkonzentration:	Water Concentration:					
Ist - Temp:	Act - Temp:					
Ist Konz 1:	Act Conc 1:					
Ist Konz 2:	Act Conc 2:					
Eingangskonzentration Komponente 1:	Input Gas Concentration Component 1:					
Eingangskonzentration Komponente 2:	Input Gas Concentration Component 2:					
Ausgangskonzentration Komponente 1:	Output Gas Concentration Component 1:					
Ausgangskonzentration Komponente 2:	Output Gas Concentration Component 2:					
Pumpe Ein/Aus:	Pump On/Off:					
Wasser / Reagent:	Water / Reagent:					
Solltemperatur:	Setpointtemperature:					
--------------------------------------------------------------------------
[END]
--------------------------------------------------------------------------
---------------------------------------------------------------------------
[O2 LEAKTEST]	[80]
--------------------------------------------------------------------------
O2 Dichtheitstest	O2 Leak Test					
Einstellungen	Settings					
Nullgas Aufschaltzeit:	Zero Gas Cutt-Off Time:					
Datenerfassungszeit:	Data recording time:					
Kalibriergas	Calibration Gas					
Aufschaltpunkt	CalGas over					
Grenzwert: O2	Limit Value: O2					
Grenzwert: Messgasdruck	Limit Value: Meassuring gas pressure					
Test - Sequenz	Test - Sequence					
Ergebnis	Result					
Messgasdruck	Meassuring gas pressure					
Ergebnis: O2	Result: O2					
Ergebnis: Messgasdruck	Result: Meassuring gas pressure					
Einstellungen geändert	Settings changed					
Pfad und Name geändert:	Path and Name changed:					
Test gestartet:	test started:					
Test abgebrochen:	Test aborted:					
Protokoll gespeichert:	Protocol saved:					
--------------------------------------------------------------------------
[END]
--------------------------------------------------------------------------
---------------------------------------------------------------------------
[CG TEST RESULT]	[81]
--------------------------------------------------------------------------
CG-Test Ergebnis	CG-Test Result
Testgas Auswertung	CG Result					
Komponente	Component					
Sollwert	Setpoint	
Istwert	Actual Value	
Max. Abweichung	Max. Deviation					
Aktuerller Wert	Actual Value					
Abweichung in % 	Deviation in % 					
Status	State					
Zeit	Time					
Bestätigen	Confirm	
NICHT BESTANDEN	NOT PASSED
Bestanden	Passed
Vorzeitig beendet!!!	Aborted!				
--------------------------------------------------------------------------
[END]
--------------------------------------------------------------------------
---------------------------------------------------------------------------
[GASTEILER ABWEICHUNG]	[82]
--------------------------------------------------------------------------
Gasteiler Abweichung	Gasdivider Deviation					
Abweichung	Deviation					
Gasteiler	Gasdivider					
Seriennummer	Serialnumber					
Gültigkeit bis	Valid to					
Speichern	Save					
Fertig	Done					
Aktiv	Active					
--------------------------------------------------------------------------
[END]
--------------------------------------------------------------------------
---------------------------------------------------------------------------
[EPA LIN CHECK PROTOKOLL]	[83]
--------------------------------------------------------------------------
Messgerät:	Measuring Device:					
Bearbeiter:	Operator:					
Gasteiler:	Gasdivider:					
Komponente:	Component:					
Konzentration:	Concentration:					
Ergebnis:	Result:					
Sollwerte CR ---	Setpoints CR ---					
Istwerte CR ---	Actual Values CR ---					
abs.Fehler CR ---	abs.Error CR ---					
rel.Fehler CR % vom Sollwert	rel.Error CR % from Setpoint					
Deviation CR ---	Deviation CR ---					
--------------------------------------------------------------------------
[END]
--------------------------------------------------------------------------
---------------------------------------------------------------------------
[LIN CHECK PROTOKOLL]	[84]
--------------------------------------------------------------------------
Linearity Check	Linearity Check					
Messgerät:	Measuring Device:					
Bearbeiter:	Operator:					
Gasteiler:	Gasdivider:					
Komponente:	Component:					
Konzentration:	Concentration:					
Datum:	Date:					
geford. max. Fehler (% v. Sollw.):	valid max. Error (% f. Setp.):					
erreichter max. Fehler (%):	achieved max. Error (%):					
erreichter max. Fehler (ppm):	achieved max. Error (ppm):					
Ordnung festgelegt:	Order set to:					
Polynom-Ordnung:	Polynomial-Order:					
geforderte Genauigkeit:	required Accuracy:					
Spanfaktor:	Spanfactor:					
Sollwert CR ---	Setpoint CR ---					
Rohwert CR ---	Raw value CR ---					
Linearisiert CR ---	Linearized CR ---					
abs.Fehler CR ---	abs.Error CR ---					
rel.Fehler CR % vom Sollwert	rel.Error CR % from Setpoint					
Deviation CR ---	Deviation CR ---					
Temp. Messzelle CR in °C	Temperature Cell CR in °C					
Druck Messzelle CR in atm	Presure Cell CR in atm					
Polynomkoeffizient:	Polynomial coefficient:					
Konstante	Constant					
1.Ordnung	1.Order					
2.Ordnung	2.Order					
3.Ordnung	3.Order					
4.Ordnung	4.Order					
--------------------------------------------------------------------------
[END]
--------------------------------------------------------------------------
---------------------------------------------------------------------------
[LEAK CHECK PROTOKOLL]	[85]
--------------------------------------------------------------------------
Dichtheitstest	Leak Check					
Messgerät:	Measuring Device:					
Serien Nummer:	Serial Number:					
Bearbeiter:	Operator:					
Startzeit:	Starting Time:					
Endzeit:	Ending Time:					
Startdruck:	Starting Pressure:					
Enddruck:	Ending Pressure:					
Umfang:	Scope:					
Dauer Dichtheitstest:	Duration Leak Check:					
zul. Druckabfall:	Valid Pressure Decrease:					
Druckanstieg:	Pressure Increase:					
Bestanden	Passed					
Nicht bestanden	Failed					
--------------------------------------------------------------------------
[END]
--------------------------------------------------------------------------
---------------------------------------------------------------------------
[O2 LEAK PROTOKOLL]	[86]
--------------------------------------------------------------------------
Messgerät:	Measuring Device:					
Serien Nummer:	Serial Number:					
Startzeit:	Starting Time:					
Endzeit:	Ending Time:					
Analysator:	Analyser:					
Aufschaltpunkt:	CalGas over:					
Nullgas Aufschaltzeit:	Zero Gas Cutt-Off Time:					
Datenerfassungszeit:	Data Recording Time:					
Grenzwert O2:	Limit Value O2:					
Grenzwert Messgasdruck:	Limit Value Meassuring gas pressure:					
Nullgas Messwert:	Zero Gas Reading:					
Messgasdruck:	Meassuring gas pressure:					
Bestanden	Passed					
Nicht bestanden	Failed					
--------------------------------------------------------------------------
[END]
--------------------------------------------------------------------------
---------------------------------------------------------------------------
[HANG UP PROTOKOLL]	[87]
--------------------------------------------------------------------------
Messgerät:	Measuring Device:					
Serien Nummer:	Serial Number:					
Startzeit:	Starting Time:					
Endzeit:	Ending Time:					
Analysator:	Analyser:					
Aufschaltpunkt:	CalGas over:					
Messbereich:	Range:					
Nullgas Aufschaltzeit:	Zero Gas Cutt-Off Time:					
Datenerfassungszeit:	Data Recording Time:					
Nullgas Messwert:	Zero Gas Reading:					
Grenzwert:	Limit Value:					
Bestanden	Passed					
Nicht bestanden	Failed					
--------------------------------------------------------------------------
[END]
--------------------------------------------------------------------------
---------------------------------------------------------------------------
[T90 PROTOKOLL]	[88]
--------------------------------------------------------------------------
T90 Test	T90 Test					
Modus:	Modus:	Mode:				
Komponente:	Component:					
Konzentration:	Concentration:					
Abweichung %:	Deviation %:					
Abschaltzeit:	Timeout:	Temporisation:				
Mittelwert Anzahl:	Average over:	Moyenne de:				
Cal Gas zu PNS	Cal Gas to PNS	Gaz d'étalonnage sur PNS				
Cal Gas	Cal Gas	Gaz d'étalonnage				
Messen	Measure	Mesure				
T10 (Delay Time):	T10 (Delay Time):	T10 (Délai de temporisation):				
T90 (Response Time):	T90 (Response Time):	T90 (Temps de réponse):				
Rise Time:	Rise Time:	temps de montée:				
T50:	T50:					
--------------------------------------------------------------------------
[END]
--------------------------------------------------------------------------
[SPRACHEDITOR]	[89]
--------------------------------------------------------------------------
Spracheditor	Language Editor
Bitte wählen Sie eine Sprache:	Please select a language:					
Seiten:	Pages:					
Deutsch:	German:					
Englisch:	English:					
Bearbeitungsspalte	Column to work on					
Speichern	Save					
Abbrechen	Cancel					
Noch nicht  gespeichert, schließen ?	Not saved yet, close ?					
Ja	Yes					
Nein	No					
--------------------------------------------------------------------------
[END]
--------------------------------------------------------------------------
--------------------------------------------------------------------------
[SYSLOG CRIO MESSAGES]	[90]
--------------------------------------------------------------------------
000 Stickstoff Befuellung.bin save	000 Stickstoff Befuellung.bin save
001 Stickstoff Befüllung Timeout - $1 sec	001 Stickstoff Befüllung Timeout - $1 sec
002 Stickstoff befüllt -  $1 sec	002 Stickstoff befüllt -  $1 sec
003 $1: Konfig load	003 $1: Konfig load
004 PID intern load	004 PID intern load
005 SPS	005 SPS
006 BSZ FT-IR	006 BSZ FT-IR
007 PID intern save	007 PID intern save
008 BSZ BMP	008 BSZ BMP
009 Setting System Time: $1	009 Setting System Time: $1
010 Stickstoff Befuellung.bin load	010 Stickstoff Befuellung.bin load
011 BSZ FT-IR.bin load	011 BSZ FT-IR.bin load
012 BSZ BMP.bin load	012 BSZ BMP.bin load
013 ErwKonfig.bin load	013 ErwKonfig.bin load
014 Anlagengrenzwerte.bin load	014 Anlagengrenzwerte.bin load
015 SysLogLevel $1	015 SysLogLevel $1
016 System.ini save	016 System.ini save
017 Anlagengrenzwerte.bin save	017 Anlagengrenzwerte.bin save
018 ErwKonfig.bin save	018 ErwKonfig.bin save
019 BSZ BMP.bin save	019 BSZ BMP.bin save
020 BSZ FT-IR.bin save	020 BSZ FT-IR.bin save
021 SysLogLevel $1 über Werkseinstellung geladen	021 SysLogLevel $1 factorysettings
022 Anlagengrenzwerte.bin über Werkseinstellung geladen	022 Anlagengrenzwerte.bin factorysettings load
023 ErwKonfig.bin über Werkseinstellung geladen	023 ErwKonfig.bin factorysettings load
024 Stickstoff Befuellung.bin über Werkseinstellung geladen	024 Stickstoff Befuellung.bin factorysettings load
025 BSZ FT-IR.bin über Werkseinstellung geladen	025 BSZ FT-IR.bin factorysettings load
026 BSZ BMP.bin über Werkseinstellung geladen	026 BSZ BMP.bin factorysettings load
--------------------------------------------------------------------------
[END]
--------------------------------------------------------------------------
--------------------------------------------------------------------------
[SYSLOG PC MESSAGES]	[91]
--------------------------------------------------------------------------
000 Fehler laden System.ini !	000 Error loading System.ini !
001 Loading System.ini OK ! SysLogLevel = $1	001 Loading System.ini OK ! SysLogLevel = $1
002 LN2 spülen	002 LN2 spülen
003 Daten Laden	003 Daten Laden 
004 Daten Speichern	004 Daten Speichern 
005 AK Name.cfg loading	005 AK Name.cfg loading	
006 AK EKFG List.txt loading	006 AK EKFG List.txt loading	
007 AK Name.cfg storing	007 AK Name.cfg storing	
008 AK EKFG List.txt storing	008 AK EKFG List.txt storing	
009 AK Befehlssatz: $1	009 AK Befehlssatz: $1	
010 Error AK - 	010 Error AK - 
011 PID Parameters - read -  empty !	011 PID Parameters - read -  empty !
012 Speichern Steuerung Fehlgeschlagen	012 Speichern Steuerung Fehlgeschlagen
013 Speichern Steuerung Abgeschlossen	013 Speichern Steuerung Abgeschlossen
014 Language changed to 	014 Language changed to 	
015 Grenzwerte Eingangsdruck FT-IR: 	015 Grenzwerte Eingangsdruck FT-IR: 
016 Grenzwerte Durchfluss FT-IR: 	016 Grenzwerte Durchfluss FT-IR: 
017 Grenzwerte Druck Ausgang: 	017 Grenzwerte Druck Ausgang: 
018 Grenzwerte Druck Kalter Block: 	018 Grenzwerte Druck Kalter Block: 
019 Grenzwerte Heizleitung intern: 	019 Grenzwerte Heizleitung intern: 
020 Grenzwerte Heizung FB: 	020 Grenzwerte Heizung FB: 
021 Grenzwerte Heizung Pumpe: 	021 Grenzwerte Heizung Pumpe: 
022 Grenzwerte Heizleitung extern: 	022 Grenzwerte Heizleitung extern: 
023 Grenzwerte Heizleitung extern SP2: 	023 Grenzwerte Heizleitung extern SP2:
024 Grenzwerte FT-IR Heizung Messzelle: 	024 Grenzwerte FT-IR Heizung Messzelle: 
025 Grenzwerte Schaltschranktemperatur: 	025 Grenzwerte Schaltschranktemperatur: 
026 Grenzwerte Gaskühler: 	026 Grenzwerte Gaskühler: 
027 Grenzwerte Heizung VFE2: 	027 Grenzwerte Heizung VFE2: 
028 Grenzwerte Heizung FB- Druckregler: 	028 Grenzwerte Heizung FB- Druckregler: 
029 Grenzwerte : 	029 Grenzwerte : 
030 Grenzwerte : 	030 Grenzwerte : 
031 Grenzwerte : 	031 Grenzwerte : 
032 Grenzwerte : 	032 Grenzwerte : 
033 Grenzwerte : 	033 Grenzwerte : 
034 Grenzwerte : 	034 Grenzwerte : 
035 Grenzwerte : 	035 Grenzwerte : 
036 Calibration not completed successful	036 Calibration not completed successful	
037 Calibration completed successful	037 Calibration completed successful	
038 Cal Gas Test: 	038 Cal Gas Test: 
039 Leak-check $1 : failed	039 Leak-check $1 : failed
040 Leak-check $1 : passed	040 Leak-check $1 : passed
041 Erw.Konfig Dichtheitstest Umfang: $1	041 Erw.Konfig Dichtheitstest Umfang: $1
042 Erw.Konfig Dichtheitstest Abfall: $1	042 Erw.Konfig Dichtheitstest Abfall: $1
043 Erw.Konfig Dichtheitstest Zeit: $1 	043 Erw.Konfig Dichtheitstest Zeit: $1
044 Erw.Konfig Stickstoff Befüllzeit: $1	044 Erw.Konfig Stickstoff Befüllzeit: $1
045 Erw.Konfig Befüllintervall: $1	045 Erw.Konfig Befüllintervall: $1
046 Erw.Konfig Befüllung deaktiviert	046 Erw.Konfig Befüllung deaktiviert
047 Erw.Konfig Befüllung aktiviert	047 Erw.Konfig Befüllung aktiviert
048 Erw.Konfig Überwachung aktiv	048 Erw.Konfig Überwachung aktiv
049 Erw.Konfig Überwachung inaktiv	049 Erw.Konfig Überwachung inaktiv
050 Erw.Konfig FT-IR Kühlung Max: $1	050 Erw.Konfig FT-IR Kühlung Max: $1
051 Erw.Konfig	051 Erw.Konfig
052 Erw.Konfig 	052 Erw.Konfig
053 Erw.Konfig	053 Erw.Konfig
054 Erw.Konfig 	054 Erw.Konfig
055 Erw.Konfig	055 Erw.Konfig
056 PID PID Druck FT-IR $1	056 PID PID Druck FT-IR $1
057 PID PID Druck Ausgang $1	057 PID PID Druck Ausgang $1
058 PID PID Druck FB $1	058 PID PID Druck FB $1
059 PID PID Druck PMD $1	059 PID PID Druck PMD $1
060 PID PID Druck NDIR $1	060 PID PID Druck NDIR $1
061 PID PID  Fluss FT-IR $1	061 PID PID  Fluss FT-IR$1
062 PID PID Gaskühler 	062 PID PID Gaskühler $1
063 PID 	063 PID
064 PID 	064 PID
065 PID 	065 PID
066 PID Heizung FB: $1	066 PID Heizung FB: $1
067 PID Heizung Pumpe: $1	067 PID Heizung Pumpe: $1
068 PID Heizung HL: $1	068 PID Heizung HL: $1
069 PID Heizung Extern: $1	069 PID Heizung Extern: $1
070 PID Heizung FB-DR: $1	070 PID Heizung FB-DR: $1
071 PID 	071 PID
072 PID 	072 PID
073 PID 	073 PID
074 PID 	074 PID
075 PID 	075 PID
076 FT-IR does not respond!	076 FT-IR does not respond!
077 H2O & CO2 to high	077 H2O & CO2 to high
078 Gaslist.bin loading	078 Gaslist.bin loading
079 Gaslist.bin storing	079 Gaslist.bin storing
080 FT-IR EVID Startadresse: $1	080 FT-IR EVID Startadresse: $1 
081 FT-IR EVID Anzahl.: $1	081 FT-IR EVID Anzahl.: $1	
082 FT-IR Komm. Leistsystem: $1	082 FT-IR Komm. Leistsystem: $1
083 FT-IR Type: $1	083 FT-IR Type: $1	
084 FT-IR Max (Laser PP, Linearizer Check, SBeam): $1	084 FT-IR Max (Laser PP, Linearizer Check, SBeam): $1	
085 FT-IR Min (Laser PP, Linearizer Check, SBeam): $1	085 FT-IR Min (Laser PP, Linearizer Check, SBeam): $1	
086 FT-IR Scans: $1	086 FT-IR Scans: $1	
087 Background not completed successful	087 Background not completed successful
088 Background completed successful	088 Background completed successful
089 Rezeptwechsel: $1	089 Rezeptwechsel: $1	
090 Error FTP WebDAV ! $1	090 Error FTP WebDAV ! $1	
091 FTP WebDAV OK using $1	091 FTP WebDAV OK using $1
092 Error reading PC Components ! 	092 Error reading PC Components ! 
093 Reading PC Components OK 	093 Reading PC Components OK 
094 Installed on cRIO: $1	094 Installed on cRIO: $1
095 Installed on PC: $1	095 Installed on PC: $1	
096 Zustand: $1	096 Zustand: $1
097 Betriebsart: $1	097 Betriebsart: $1	
098 Samplepoint: $1	098 Samplepoint: $1
099 Hintergrund not completed successful	099 Hintergrund not completed successful
100 Hintergrund completed successful	100 Hintergrund completed successful
101 Log Konfig File max. Größe: $1	101 Log Konfig File max. Größe: $1	
102 Passwort Level = $1	102 Passwort Level = $1	
103 Optionen Störmeldep.: $1	103 Optionen Störmeldep.: $1
104 Optionen Betriebszustände: .: $1	104 Optionen Betriebszustände: .: $1
105 Optionen AK in ppm: $1	105 Optionen AK in ppm: $1
106 Optionen log Cal-Gas: $1	106 Optionen log Cal-Gas: $1
107 Optionen log 0-Gas: $1	107 Optionen log 0-Gas: $1
108 Optionen log CG zu PNS: $1	108 Optionen log CG zu PNS: $1
109 Optionen PNS?: $1	109 Optionen PNS?: $1
110 Optionen Mit N2 spülen: $1	110 Optionen Mit N2 purge: $1
111 Optionen LeakCheck vor Kal:: $1	111 Optionen LeakCheck before Kal:: $1
112 Optionen	112 Optionen
113 Optionen	113 Optionen
114 Optionen	114 Optionen
115 Optionen	115 Optionen
116 Optionen	116 Optionen
117 Optionen	117 Optionen
118 Optionen	118 Optionen
119 Optionen	119 Optionen
120 Optionen	120 Optionen
121 Laden System Settings	121 Loading System Settings
122 Speichern System Settings	122 Saving System Settings
--------------------------------------------------------------------------
[END]
--------------------------------------------------------------------------
--------------------------------------------------------------------------
[SYSLOG PROPERTIES MESSAGES]	[92]
--------------------------------------------------------------------------
ein	on
aus	off
--------------------------------------------------------------------------
[END]
--------------------------------------------------------------------------
---------------------------------------------------------------------------
[T90 EPA]	[93]
--------------------------------------------------------------------------
Anderer Test läuft gerade. CR Bitte etwas Geduld.	Another Test is running. CR Please wait a moment.
T90 Test (EPA 1065-308) läuft	T90 Test (EPA 1065-308) is running
Leak Check Test (EPA 1065-345) läuft	Leak Check Test (EPA 1065-345) is running
Interference Test (EPA 1065-366) läuft	Interference Test (EPA 1065-366) is running
Interference  Test (EPA 1065-375) läuft	Interference  Test (EPA 1065-375) is running
ARN Test (EPA 1065-305) läuft	ARN Test (EPA 1065-305) is running
Bearbeiter:	Operator:
Messgerät:	Analyzer:
N2 Aufschaltzeit:	N2 Purgetime:
Seriennummer:	Serial number:
Komponente:	Component:
Gasflaschen Nr.:	Gas Bottle Nr.:
Konzentration:	Setpoint:
Genauigkeit:	Accuracy:
CG Aufschaltzeit:	CG Purge Time:
Abweichung:	Deviation:
Abschaltzeit:	Timeout:
Pfad:	Path:
Textname:	Filename:
Protokoll Einstellung	Protocol Settings
Allgemeine Einstellungen	General Settings
Einstellung	Settings
Ergebnis	Result
Speichern	Save
Abbrechen	Cancel
Istwert:	Actual Value:
PDF erstellen	Print to PDF
Grenzen	Limits
gemittelter T10-T90	Averaged T10-T90
gemittelter T90-T10	Averaged T90-T10
Anstiegszeit CR in [sec]	Rise Time CR in [sec]
Abfallzeit CR in [sec]	Fall Time CR in [sec]
T90 Test gestartet	Start T90 Test
Cal-Gas wird aufgeschalten	Cal-Gas running
Höchster Peak von der Komponente wird ermittelt	The highest peak of the component is determined
Timeout. Höchster Peak liegt außerhalb der Grenzwerte	Timeout. Highest peak is out of the limits
Sequenz wird gestartet. CR Responsetime wird ermittelt.	Sequence is started. CR Responsetime is determined.
Sequenz Responsetime T10-T90:	Sequence Responsetime T10-T90:
N2 wird aufgeschalten	Purge with N2
Sequenz Responsetime T90-T10:	Sequence Responsetime T90-T10:
CG wird aufgeschalten	Purge with Cal-Gas
T90 Test abgeschlossen	T90 Test completed
T90 Test wurde abgebrochen.	T90 Test was canceled
CG zu PNS	Cal Gas to PNS	Gaz d'étalonnage sur PNS				
CG zu Entnahmestelle	Cal Gas to Samplepoint	
--------------------------------------------------------------------------
[END]
--------------------------------------------------------------------------
---------------------------------------------------------------------------
[T90 EPA PDF]	[94]
--------------------------------------------------------------------------
Bearbeiter:	Operator:
Messgerät:	Analyzer:
Seriennummer:	Serial number:
Komponente:	Component:
Gasflaschen Nr.:	Gas Bottle Nr.:
Konzentration:	Setpoint:
Genauigkeit:	Accuracy:
CG Aufschaltzeit:	CG Purge Time:
Abweichung:	Deviation:
Abschaltzeit:	Timeout:
Pfad:	Path:
Textname:	Filename:
Protokoll Einstellung	Protocol Settings
Allgemeine Einstellungen	General Settings
Einstellung	Settings
Ergebnis	Result
Speichern	Save
Abbrechen	Cancel
Istwert:	Actual Value:
PDF erstellen	Print to PDF
Grenzen	Limits
gemittelter T10-T90	Averaged T10-T90
gemittelter T90-T10	Averaged T90-T10
Anstiegszeit CR in [sec]	Rise Time CR in [sec]
Abfallzeit CR in [sec]	Fall Time CR in [sec]
Datum & Uhrzeit:	Date & Time:
Ergebnis:	Result:
Anlage:	Measuring Device:
--------------------------------------------------------------------------
[END]
--------------------------------------------------------------------------
---------------------------------------------------------------------------
[SCHEDULER]	[95]
--------------------------------------------------------------------------
Zeitgesteuerte Routine	Time-controlled routine
Manuelle/Remote Routine	Manual/Remote routine
Auto Scheduler Status:	Auto scheduler status:
akiv	active
inaktiv	inactive
Reihenfolge:	Sequence:
Reihenfolge [SATK]:	Sequence [SATK]:
Dichtheitstest	Leak-check
Kalibrieren	Calibration
Montag	Monday
Dienstag	Tuesday
Mittwoch	Wednesday
Donnerstag	Thursday
Freitag	Friday
Samstag	Saturday
Sonntag	Sunday
Ergebnisse	Results
--------------------------------------------------------------------------
[END]
--------------------------------------------------------------------------