cRio_aktiv	TRUE
LP_Anlage	TRUE
EPA_aktiv	TRUE
SysLogAktiv	TRUE
BullZip	TRUE
Kondensatbehaelter	TRUE
FID	FALSE
PMA	FALSE
Klima	FALSE
Purifier	FALSE
Filter_Spuelen	FALSE
Pumpe_Spuelen	FALSE
Pumpe_Regelung	FALSE
Pumpe_DFR	TRUE
Zirkonia	FALSE
Heizleitung_SP2	FALSE
Filterblock_vorhanden	FALSE
Regelung_Ausgang_vorhanden	TRUE
Amium_PNS_aktiv	FALSE
LN2_Befuellung	TRUE
Watlow_Regler	FALSE
Gehaeuseluefter	TRUE
Vortex_Kuehlung	FALSE
AK_IAVF	TRUE
Paccar	FALSE
50l_N2_Tank	FALSE
EIN_AUS_UL	FALSE
HovaCALInterface	FALSE
Spaneingaenge	3
Ventile_manuell_schalten	FALSE
External_LCV	FALSE